9,16
36
0
5000
...e@e@e..ee@...
w.e@e.....@.e..w
...e@.e@e.e.....
....e.e@e...@e..
w.e.....@e@.e..w
..@e@e.ee.e.....
.....e.@..@.ee..
w..e@@.e.ee.@@.w
....ee...@e.ee..