33,36
413
0
5000
..@e..e@.eee@e.e@....e@..@e.e@.e....
w.e.e@eee@@e....e.....e..e@eeee@...w
..@.e@e.....e@ee@.e..e@.e...@@ee....
..ee@@eeee@e@@eeee@.e@.e@...eee.e...
w.@e.ee@@e..ee@@..e..e.@...e.e@e@e.w
...@ee@.@e.e@e.ee@e..@eee..@..e@....
....e.eee@...e.e@e.@e.@e@.@ee@@e@...
w..e@.e@...ee@e.e@.ee@e...e@.e..e..w
...@.....e@@@e.@e..@@e..e..@e@@e....
..ee@e....eee..ee@.ee..e@.@ee.e.e@..
w.@..e..@eee@...ee.e@.e.e.e.@.e@ee.w
..e.e@e@ee@.e..e@.@e@.@e....e@.e@e..
..e@...@ee@e@..@e.e.e.@e.....ee@.e..
w..e.e.e.e@ee@..@e.ee.ee@@e.e...e@.w
....e@..e.@e.ee.e@e@@ee@ee..@.......
.....eee@eee..@e...ee@......ee@.e...
w.@e.e@ee@.@e..e.ee@.e...e@e.eee@..w
..ee@ee.e@e@e..@e@e@e@.e....e@e.....
.....e..e@@e@.e@...e...@e..eeee..e..
w..ee@e.@ee....e.....@e....@@e@e.@.w
...@.e.ee.@e....e@ee@eee@e.e.@.e@e..
...eeee@..@e......e@.e@.eee@ee.@ee..
w.@e@@.e..e@@ee@..e@e.e..@e@e..ee@.w
..ee@eee@.@eee.e@e....@e@.e....e.e..
......@.eee..@e@@e.@eee.ee@.@e.@....
w..@e.e@e@ee@e..ee@e.@..@.e.ee@eee.w
...e......eee@@e@..e@e@ee....@.e@@..
....ee@@e.@@e.e.e..@.e@e....eee..e..
w.@e@.ee@.e.ee...e@e.@ee@ee@@e@ee..w
..e@...e@e@e@@e@..e...@....e@eee@e..
..e.e@@e@e....@e.ee@eee.e@.@e....e..
w.@.@eee.@@e.e@e.@e@e@ee.e..@eee@@.w
..e.e@e@eee@e..e@e.e.ee@e...ee@.ee..