9,16
37
0
5000
.......e@e@ee@..
w.....e@e....e.w
....@e....ee....
....e....e@@e...
w.....@e.ee@e..w
....e@e@.@.e@e..
..e....e.e.e@e..
w.@eee.e....ee.w
...e@@e@e@e.e@..