{
    "name": "kiva_uneven_debug",
    "weight": false,
    "n_row": 33,
    "n_col": 36,
    "n_endpoint": 413,
    "n_agent_loc": 0,
    "maxtime": 5000,
    "layout": [
        "..eeee.ee.ee.ee.e..ee..ee..ee..ee...",
        "w....e..e....e..e..ee..ee..ee..e.e.w",
        "..e.................................",
        ".................................e..",
        "w.e................................w",
        "....................................",
        "..e.................................",
        "w..................................w",
        "..e.................................",
        "....................................",
        "w.e................................w",
        "....................................",
        "..e.................................",
        "w..................................w",
        "..e.................................",
        "....................................",
        "w.e................................w",
        "....................................",
        "..e.................................",
        "w..................................w",
        "..e.................................",
        "....................................",
        "w.e................................w",
        "....................................",
        "..e.................................",
        "w..................................w",
        "..e.................................",
        "....................................",
        "w..................................w",
        "...e................................",
        "....................................",
        "w..................................w",
        "...................................."
    ]
}