{
    "name": "kiva_69x69_cma-mae_opt_entropy_uneven_throughput_hamming_a=0",
    "layout": [
        ".....e...@e@@e@@e@@e@@e@@e@@e@@e@@e@@e@@e@@e@@e@@e@.@e@@e@@e@@e@@e@..",
        "w..e.@.e............................................................w",
        "...@.e.@..........................................................e..",
        "...e.e.e.@ee@@e@e@@e.e@@e@e@@e@@e.e@@e.e@@e@@e@@e@.e@@ee@@e@@e@@e@@..",
        "w..e.@.e............................................................w",
        "...@.e.@.e@@......................................................e..",
        "...e.e.e.e.e.@ee@@ee@@e@@e@e@@e@@ee@.e@@e@@e@e@@e@@e..@e@e@@e@@ee@@..",
        "w..e.@.e.@.e........................................................w",
        "...@.e.@.e.@.e@@..................................................e..",
        "...e.e.e.e.e.e.e.@e@@e@@e@.@e@@e.@e@e@@e@e@@e.e@@e@@e@@e@@e@@e@@e@@..",
        "w..e.@.e.@.e.@.e....................................................w",
        "...@.e.@.e.@.e.@.e@@..............................................e..",
        "...e.e.e.e.e.e.e.e.e.@e@e@@e@@e@@e@@e@@e@@e@@e@@e@.@e@@e@@e@@e@@e@@..",
        "w..e.@.e.@.e.@.e.@.e................................................w",
        "...@.e.@.e.@.e.@.e.@.e@@..........................................e..",
        "...e.e.e...e.e.e.e.e.e.e.@e@@e@@e@@e@@e@e@@e@@e@.@e@e@@e@@e@@e@@e@@..",
        "w..e.@.e.e.e.@.e.@.e.@.e............................................w",
        "...@.e.@.@.@.e.@.e.@.e.@.e@@......................................e..",
        "...e.e.e.e.e.e.e.e.e.e.e.e.e.@e@@e@@e@@e@@e@@e@@e@ee@@e@@e@@ee@@e@@..",
        "w..e.@.e.e.e.@.e.@.e.@.e.@.e........................................w",
        "...@.e.@.@.@.e.@.e.@.e.@.e.@.e@@..................................e..",
        "...e.e.e.e.e.e.e.e.e.e.e.e.e.e.e.@@e@e@e@@e@@e@@e@@e@@ee@@e@@e@@e@@..",
        "w..e.@.e.e...@.e.@.e.@.e.@.e.@.e.e..................................w",
        "...@.e.@.@.e.e.@.e.@.e.@.e.@.e.@.e................................e..",
        "...e.e.e.e.@.e.e.e.e.e.e.e.e.e.e.@.@e@@e@@e@@ee@@e@@e@@e@@e@@e@@e@@..",
        "w..e.@.e.e.e.@.e.@.e.@.e.@.e.@.e.e..................................w",
        "...@.e.@.@.e.e.@.e.@.e.@.e.@.e.@.e.e@e@@e@@e@@e@@e@@e@@e@@e@e@@e@@e..",
        "...e.e.e.e.@.e.e.e.e.e.e.e.e.e.e.@...................................",
        "w..e.@.e.e.e.@.e.@.e.@.e.@.e.@.e.e..................................w",
        "...@.e.@.@...e.@.e.@.e.@.e.@.e.@.e.e@@e@.@e@e@@e@@e@@e@@e@@e@e@@e@...",
        "...e.e.e.e.e.e.e.e.e.e.e...e.e.e.@...................................",
        "w..e.@.e...@.@.e.@.e.@.e.e...@.e.e.e@@e@@ee@@e@@e@@e@@e@@e@@e@@e@e@.w",
        "...@.e.@.e.e.e.@.e.@.e.@.@.e.e.@.e...................................",
        "...e.e.e.@.e.e.e.e.e.e.e.e.@.e.e.@.e@@e@@e.@e@@e@@e@@e@@e@@e@@e@@e@..",
        "w..e.@.e.e.@.@.e.@.e.@.e.e.e.@.e.e..................................w",
        "...@.e.@.e.e.e.@.e.@.e.@.@.e.e.@.e.e@@e@@ee@@e@@e@@e@@e@@e@e@@e@@e@..",
        "...e.e.e.@.e.e.e.e.e...e.e.@.e.e.@...................................",
        "w..e.@.e.e.@.@.e.@.e.e@e.e.e.@...e.e@@e@@ee@@e@e@@e@@e@@e@@e@@e@@e@.w",
        "...@.e.@.e.e.e.@.e.@.e.e.@.e.e.e.e...................................",
        "...e.e.e.@.e...e.e.e.@.@.e.@.e.@e@..@e@@e@@e@@e@@e@@e@@ee@@e@@e@@e@..",
        "w..e.@.e.e.@.e.e.@.e.e.e.e.e.@......................................w",
        "...@.e.@.e.e.@.@.e.@.e.e.@.e.e..e@e@@e@@e@@e@@e@@e@@ee@@e@e@@e@..e@..",
        "...e.e.e.@.e.e.e.e.e.@.@.e.@.........................................",
        "w..e.@.e.e.@.e.e.@.e.e.e.e.e.e@@e@.e@e@@e@e@@e@@e@@e@@e@@e@@e@@e@e@.w",
        "...@.e.@.e.e.@.@.e.@.e...@...........................................",
        "...e.e.e.@.e.e.e.e.e.@.e.e..@e@@ee@@e@@ee@@e@@e@@e@@e@@e@@e@@e@e.e@..",
        "w..e.@.e.e.@.e...@.e.e.@............................................w",
        "...@.e.@.e.e.@.e.e.@.e.e..e@@e@e@.@e.e@@e@.@e@@e@@e@@e@@e@@e@@e@@e@..",
        "...e.e.e.@.e.e.@.e.e.@...............................................",
        "w..e.@.e.e.@.e.e.@.e.e.@e@@e@@e@..e@@e@@e@e@@e@@e@e@e@e@@e@e@@e@@e@.w",
        "...@.e.@.e.e.@.e.e.@.................................................",
        "...e.e.e.@.e.e.@.e.e.@e...@ee@@ee@e@@e@@e@@e@@e@@e@@e@@e@@e@@e@@e@...",
        "w..e.@.e.e.@.e.e.@..................................................w",
        "...@.e.@.e.e.@.e.e.@e@@e@.e@@e@@e@@e@@e@@e@@e@.e@@e@@e@@e@@e@@e@@e@..",
        "...e.e.e.@.e.e.@.....................................................",
        "w..e.@.e.e.@.e.e.@e@@e@.e@@e@@e@@e@@e....e@@e@@e@.@e@@e@@e@@e@@e@@e.w",
        "...@.e.@.e.e.@.......................................................",
        "...e.e.e.@.e.e.@e@@e..@e@@e@@e@.e@@e@@e@@e@@e@@e@@e@@e@@e@@e@@ee@@e..",
        "w..e.@.e.e.@........................................................w",
        "...@.e.@.e.e.e@@e@@e@.e@.e@.e@@e@@e@e@ee@@e@@e@@e@@e@@e.e@@e@@e@@e@..",
        "...e.e.e.@...........................................................",
        "w..e.@.e.e..@e@e@@e@@e@..e@@e.........e@@e@@e@@e@@e@@e@@e@@e@@e@@e@.w",
        "...@.e.@.............................................................",
        "...e.e.e.@e@e@@e@@e@@e@e@@e@@e@@e@e@@e@@e@@e@@e@@ee@@e@@e@@e@@e@@e@..",
        "w....@..............................................................w",
        "...e.e.e@@e@@ee@@e@@e@@e@e@@e@@ee@@e.e@@e@@e@@e@@e@e@@e@@e.e@@e@@e...",
        "...@.................................................................",
        "w..e.@ee@@ee@e@@e@@e@@e@@e@@e@e@@e@@e@@e@@e@@e@@e@@e@@e@e@@e@@e@@e@.w",
        "....................................................................."
    ],
    "nca_runtime": 0.11974859237670898,
    "milp_runtime": 48.49936079978943,
    "nca_milp_runtime": 48.61910939216614,
    "sim_score": null,
    "weight": false,
    "n_row": 69,
    "n_col": 69,
    "n_endpoint": 919,
    "n_agent_loc": 0,
    "n_shelf": 1020,
    "maxtime": 5000
}