{
    "name": "kiva_69x69_cma-mae_opt_entropy_throughput_hamming_a=5",
    "layout": [
        ".....................................................................",
        "w.@ee@@ee@@ee@@ee@@ee@@ee@@ee@@ee@@ee@..........e@@ee@..e@@ee@@e.e@.w",
        ".....................................................................",
        "..@ee@@ee@@ee@@ee@@ee@@ee@@ee@@ee@@e..@ee@@ee@@ee@@ee@@ee@@ee@.e@e...",
        "w...................................................................w",
        "..@ee@@ee@@ee@@ee@@ee@@ee@@ee@@ee@@ee@@ee@@ee@@ee@@ee@@ee@@ee@@e.e@..",
        ".....................................................................",
        "w.@ee@@ee@@ee@@ee@@ee@@ee@@ee@@ee@@ee@@ee@@ee@@ee@@ee@@ee@@ee@@ee@..w",
        ".....................................................................",
        "..@ee@@ee@@ee@@ee@@ee@@ee@@ee@@ee@@ee@@ee@@ee@@ee@@ee@@ee@@ee@@ee@e..",
        "w...................................................................w",
        "..@ee@@ee@@ee@@ee@@ee@@ee@@ee@@ee@@ee@@ee@@ee@@ee@@ee@@ee@@ee@@e.e@..",
        ".....................................................................",
        "w.@ee@@ee@@ee@@ee@@ee@@ee@@ee@..e@@ee@@ee@@ee@@ee@@ee@@ee@@ee@@ee@..w",
        ".....................................................................",
        "..@ee@@ee@@ee@@ee@@ee@@ee@@ee@@ee@@ee@@ee@@ee@@ee@@ee@@ee@@ee@@ee@e..",
        "w...................................................................w",
        "..@e......@ee@@ee@@ee@@ee@@ee@@ee@@ee@@ee@@ee@@ee@@ee@@ee@@ee@@e.e@..",
        ".....................................................................",
        "w.@ee@..........e@@ee@@ee@@ee@@ee@@ee@@ee@@ee@@ee@@ee@@ee@@ee@......w",
        ".....................................................................",
        "..@ee@@e..@ee@@ee@@ee@@ee@@ee@@ee@@ee@@ee@@ee@@ee@@ee@@ee@@ee@@ee@e..",
        "w...................................................................w",
        "..@ee@@ee@@e..@ee@@ee@@ee@@ee@@ee@@ee@@ee@@ee@@ee@@ee@@ee@@ee@@e.e@..",
        ".....................................................................",
        "w.@ee@@ee@@e..@ee@@ee@@ee@@ee@@ee@@ee@@ee@@ee@@ee@@ee@@ee@@ee@@ee@..w",
        ".....................................................................",
        "..@ee@..e@@ee@@ee@@ee@@ee@..e@@ee@@ee@@ee@@ee@@ee@@ee@@ee@@ee@@e.....",
        "w...................................................................w",
        "..@e.e@ee@@ee@@ee@@ee@@ee@@ee@@ee@@ee@@ee@@ee@@ee@@ee@@ee@@ee@@e.e@..",
        ".....................................................................",
        "w...e@@ee@@ee@@ee@@ee@@ee@@ee@@ee@@ee@@ee@@ee@@ee@@ee@@ee@@ee@@ee@..w",
        ".....................................................................",
        "..@e....e@@ee@@ee@@ee@@ee@@ee@@ee@@ee@@ee@@ee@@ee@@ee@@ee@@ee@@ee@e..",
        "w...................................................................w",
        "..@e....e@@ee@@ee@@ee@@ee@@ee@@ee@@ee@@ee@@ee@@ee@@ee@@ee@@e..@e.e@..",
        ".....................................................................",
        "w.@e....e@@ee@@ee@@ee@@ee@@ee@@ee@@ee@@ee@@ee@..e@@ee@@ee@@ee@@e....w",
        ".....................................................................",
        "..@ee@@ee@@ee@@ee@@ee@@ee@@ee@@ee@@ee@@ee@@ee@@ee@@ee@@ee@@ee@@e.....",
        "w...................................................................w",
        "..@ee@@e....e@@ee@@ee@@ee@@ee@@ee@@ee@@ee@@ee@@ee@@ee@@ee@@ee@...e@..",
        ".....................................................................",
        "w.@ee@@e.e@ee@@ee@@ee@@ee@@ee@@ee@@ee@@ee@@ee@@ee@@ee@@ee@@ee@..e@e.w",
        ".....................................................................",
        "..@e....e@..e@@ee@@ee@@ee@@ee@@ee@@ee@@ee@@ee@@ee@@ee@@ee@@ee@@e.....",
        "w...................................................................w",
        "..@ee@@ee@@ee@@ee@@ee@@ee@@ee@@ee@@ee@@ee@@ee@@ee@@ee@@ee@@ee@e..e@..",
        ".....................................................................",
        "w.@ee@@ee@@ee@@ee@@ee@@ee@@ee@@ee@@ee@@ee@@ee@@ee@@ee@@ee@@ee@@e....w",
        ".....................................................................",
        "..@ee@@ee@@e..@ee@@ee@@ee@@ee@@ee@@ee@@ee@@ee@@ee@@ee@@ee@@ee@@ee@e..",
        "w...................................................................w",
        "..@ee@@ee@@ee@..e@@ee@@ee@@ee@@ee@@ee@@ee@@ee@@ee@@ee@@ee@@ee@@e.e@..",
        ".....................................................................",
        "w.@ee@@e..@ee@@ee@@ee@@ee@@ee@@ee@@ee@@ee@@ee@@ee@@ee@@ee@@ee@@ee@e.w",
        ".....................................................................",
        "..@e....e@@ee@@ee@@ee@@ee@@ee@@ee@@ee@@ee@@ee@@ee@@ee@@ee@@ee@@ee@e..",
        "w...................................................................w",
        "..@e.e@e..@ee@..e@@ee@@ee@@ee@@ee@@ee@@ee@@ee@@ee@@ee@@ee@@ee@@e.e@..",
        ".....................................................................",
        "w.@e....e@...e@ee@@ee@@ee@@ee@@ee@@ee@@ee@@ee@@ee@@ee@@ee@@ee@@e....w",
        ".....................................................................",
        "..@e....e@e.e@@ee@@ee@@ee@@ee@@ee@@ee@@ee@@ee@@ee@@ee@@ee@@ee@.e@e...",
        "w...................................................................w",
        ".....e@ee@@ee@e.e@@ee@@ee@@ee@@ee@@ee@@ee@@ee@@ee@@ee@@ee@@ee@@e.e@..",
        ".....................................................................",
        "w.@ee@@ee@@ee@@ee@@ee@@ee@@ee@@ee@@ee@@ee@@ee@@ee@@ee@@ee@@ee@@ee@..w",
        "....................................................................."
    ],
    "nca_runtime": 0.12250423431396484,
    "milp_runtime": 7.95844578742981,
    "nca_milp_runtime": 8.080950021743774,
    "sim_score": null,
    "weight": false,
    "n_row": 69,
    "n_col": 69,
    "n_endpoint": 1038,
    "n_agent_loc": 0,
    "n_shelf": 1020,
    "maxtime": 5000
}