{
    "name": "kiva_81x80_cma-mae_opt_entropy_throughput_hamming_a=5",
    "layout": [
        "................................................................................",
        "w..e@@e..@ee@@ee@@ee@@ee@@ee@@ee@@ee@@ee@@ee@@ee@@ee@@ee@@ee@@ee@@ee@@ee@@e.e@.w",
        "................................................................................",
        "...e@@ee@@ee@@ee@@ee@@ee@..e@@ee@@ee@@ee@@ee@@ee@@ee@@ee@@ee@@ee@@ee@@ee@.e@e...",
        "w..............................................................................w",
        "...e@@ee@@ee@@ee@@ee@@ee@@ee@@ee@@ee@@ee@@ee@@ee@@ee@@ee@@ee@@ee@@ee@@ee@@e.e@..",
        "................................................................................",
        "w..e@..e@@ee@e.e@@e..@ee@@ee@@ee@@ee@@ee@@ee@@ee@@ee@@e..@ee@@ee@@ee@@ee@@ee@..w",
        "................................................................................",
        "...e@@ee@@ee@@ee@@ee@@ee@@ee@@ee@@ee@@ee@@ee@@ee@@ee@@ee@@ee@@ee@@ee@@ee@@ee@e..",
        "w..............................................................................w",
        ".....@ee@@ee@@ee@@ee@..e@@ee@@ee@@ee@@ee@@ee@@ee@@ee@@ee@@ee@@ee@@ee@@ee@@e.e@..",
        "................................................................................",
        "w..e@@ee@@ee@@e..@ee@@ee@@ee@@ee@@ee@@ee@@ee@@ee@@ee@@ee@@ee@@ee@@ee@@e..@ee@..w",
        "................................................................................",
        "...e@@ee@@ee@@ee@@ee@@ee@@ee@@ee@@ee@@ee@@ee@@ee@@ee@@ee@@ee@@ee@@ee@@ee@.e@e...",
        "w..............................................................................w",
        "...e@@ee@@e..@ee@@ee@@ee@@ee@@ee@@ee@..e@@ee@@ee@@ee@@ee@@ee@@ee@@ee@@e.....e@..",
        "................................................................................",
        "w..e@@ee@@ee@@ee@@ee@@ee@@ee@@ee@@e..@ee@@ee@@ee@@ee@@ee@@ee@@ee@@ee@@e..@e....w",
        "................................................................................",
        "...e@@ee@@ee@@ee@@ee@@ee@@ee@@ee@@ee@@ee@@ee@@ee@@ee@@ee@@ee@@ee@@ee@@ee@@ee@e..",
        "w..............................................................................w",
        "...e@@ee@@ee@@ee@@ee@@ee@..e@@ee@@ee@@ee@@ee@@ee@..e@@ee@@ee@@ee@@ee@@ee@@e.e@..",
        "................................................................................",
        "w...e@ee@@ee@@ee@@ee@@ee@@ee@@ee@@ee@@ee@@ee@@ee@@ee@@ee@@e..@ee@@ee@@ee@@ee@..w",
        "................................................................................",
        "...e@@ee@@ee@@ee@@ee@@ee@@ee@@ee@@ee@@ee@@ee@@ee@@ee@@ee@@ee@@ee@@ee@@ee@@ee@e..",
        "w..............................................................................w",
        ".....@ee@@ee@@ee@@ee@@ee@@ee@@ee@@ee@@ee@@ee@@ee@@ee@@ee@@ee@@ee@@ee@@ee@.e@e...",
        "................................................................................",
        "w..e@@ee@@ee@@ee@@ee@@ee@@ee@@ee@@ee@@ee@@ee@@ee@@ee@@ee@@ee@@ee@@ee@@ee@@ee@..w",
        "................................................................................",
        ".....@ee@@ee@@ee@@ee@@ee@@ee@@ee@@ee@@ee@@ee@@ee@@ee@@ee@@ee@@ee@@ee@@ee@@ee@e..",
        "w..............................................................................w",
        "...e@@ee@@ee@@ee@@ee@@ee@@ee@@ee@@ee@@ee@@ee@@ee@@ee@@ee@@ee@@ee@@ee@@ee@@e.e@..",
        "................................................................................",
        "w..e@@ee@@ee@@ee@@ee@@ee@@ee@@ee@@ee@@ee@@ee@@ee@@ee@@ee@@ee@@ee@@ee@@ee@@ee@..w",
        "................................................................................",
        "...e@......e@@ee@@ee@@ee@..e@@ee@@ee@@ee@@ee@@ee@@ee@@ee@@ee@@ee@@ee@@ee@@ee@e..",
        "w..............................................................................w",
        "...e@@ee@@ee@@ee@@ee@@ee@@ee@@ee@@ee@@ee@@ee@@ee@@ee@@ee@@ee@@ee@@ee@@ee@.e@e...",
        "................................................................................",
        "w..e@@ee@@ee@@ee@@ee@@ee@@ee@@ee@@ee@..e@@ee@@ee@@ee@@ee@@ee@@ee@@ee@@ee@@ee@..w",
        "................................................................................",
        "...e@@ee@@ee@@ee@@ee@@ee@@ee@@ee@@ee@@ee@@ee@@ee@@ee@@ee@@ee@@ee@@ee@@ee@@ee@e..",
        "w..............................................................................w",
        "...e@@ee@@ee@@ee@@ee@@ee@@ee@@ee@@ee@@ee@@ee@@ee@@ee@@ee@@ee@@ee@@ee@@ee@@e.e@..",
        "................................................................................",
        "w..e@@ee@@ee@@ee@@ee@@ee@@ee@@ee@@ee@@ee@@ee@@ee@@ee@@ee@@ee@@ee@@ee@@ee@@ee@..w",
        "................................................................................",
        "...e@@e..@ee@@ee@@ee@@ee@@ee@@ee@@ee@@ee@@ee@@ee@@ee@@ee@@ee@@ee@@ee@@ee@@ee@e..",
        "w..............................................................................w",
        ".......e@@e....e@@ee@..e@@ee@@ee@@ee@@ee@@ee@@ee@@ee@@ee@@ee@@ee@@ee@@ee@@e.e@..",
        "................................................................................",
        "w................@e..@e..@ee@@ee@@ee@@ee@@ee@@ee@@ee@@e..@ee@@ee@@ee@@ee@@ee@..w",
        "................................................................................",
        "...e@@ee@@e....e@@ee@@ee@..e@@ee@@ee@@ee@@ee@@ee@@ee@@ee@@ee@@ee@@ee@@ee@@e.....",
        "w..............................................................................w",
        "...e@@ee@@e..@ee@@ee@@e..@ee@@ee@@ee@@ee@@ee@@ee@@ee@@ee@@ee@@ee@@ee@@ee@@e.e@..",
        "................................................................................",
        "w..e@@e....e@......e@..e@@e....e@@ee@@ee@@ee@@ee@@ee@@ee@@ee@@ee@@ee@@ee@@ee@..w",
        "................................................................................",
        ".......e@..........e@@e..@ee@..e@@ee@@ee@@ee@@ee@@ee@@ee@@ee@@ee@@e..@ee@@e.....",
        "w..............................................................................w",
        "...e@@ee@@ee@@ee@@ee@@ee@@ee@..e@@ee@@ee@@ee@@ee@@ee@@ee@@ee@@ee@@ee@@ee@@e.e@..",
        "................................................................................",
        "w..e@@ee@@e..@ee@@ee@..e@@ee@@ee@@ee@@ee@@ee@@ee@@ee@@ee@@ee@@ee@@ee@@ee@@ee@..w",
        "................................................................................",
        "...e@@ee@@e....e@@ee@@ee@@ee@@ee@@ee@@ee@@ee@@ee@@ee@@ee@@ee@@ee@@ee@@ee@@ee@e..",
        "w..............................................................................w",
        "...e@@ee@@ee@@ee@@ee@@ee@@ee@@ee@@ee@@ee@@ee@@ee@@ee@@ee@@ee@@ee@@ee@@ee@@e.e@..",
        "................................................................................",
        "w..e@@ee@@ee@@ee@@ee@@ee@@ee@..e@@ee@@ee@@ee@@ee@@ee@@ee@@ee@@ee@@ee@@ee@@ee@..w",
        "................................................................................",
        "...e@..e@@ee@@ee@@ee@@ee@@ee@@ee@@ee@@ee@@ee@@ee@@ee@@ee@@ee@@ee@@ee@@ee@@ee@e..",
        "w..............................................................................w",
        "...e@@ee@@ee@@ee@@ee@@ee@@ee@@ee@@ee@@ee@@ee@@ee@@ee@@ee@@ee@@ee@@ee@@ee@@e.e@..",
        "................................................................................",
        "w..e@@ee@@ee@@ee@@ee@@ee@@ee@@ee@@ee@@ee@@ee@@ee@@ee@@ee@@ee@@ee@@ee@@ee@@ee@e.w",
        "................................................................................"
    ],
    "nca_runtime": 0.13242483139038086,
    "milp_runtime": 9.703598499298096,
    "nca_milp_runtime": 9.836023330688477,
    "sim_score": null,
    "weight": false,
    "n_row": 81,
    "n_col": 80,
    "n_endpoint": 1416,
    "n_agent_loc": 0,
    "n_shelf": 1400,
    "maxtime": 5000
}