{
    "name": "kiva_69x69_cma-mae_opt_entropy_throughput_hamming_a=0",
    "layout": [
        "..e@@e@@@e@@e@@e@@e@@e@@e@@e@e@@e@e@e@e@@e@@e@@e@@e@@e@@ee@@e@@ee@...",
        "w..e...e.e..........................................................w",
        "....e....@ee@@e@@e@@ee@@e@@e@e@@e@e@e@@e@@e@e@@e@@e@@e@@e@@e@e@@ee@..",
        "..e.@.@..e...........................................................",
        "w.@.e.e.e.e.e.e....@.@e@.@e.....@@e@@@e@e@e@@@e@@@e@e@e@e@@@e.e@@.@.w",
        "..e.@.@.@.@.@.@....e............e.e.e.e.e.e.e.e.e.e.e.e.e.e.e.e.e.e..",
        "..e.e.e.e.e.e.e.e...............@.@.@.@.@.@.@.@.@.@.@.@.@.@.@.@.@.@..",
        "w.@.e.e.e.@.@.@.@.@ee..................e..e.e.e.e.e.e.e.e.e.e.e.e.e.w",
        "..e.@.@.@.@.e.e.e...@.@.@.@.@.@e.e@e...@.@.@e.@e@.@.@.@.@.@.@.@.@.@..",
        "..e.e.e.e.e.e.e.e.e.e.e.e.e.e.e.@.e.e....e........e.e.e.e.e.e.e.e.e..",
        "w.@.@.@...@.@.@.@.@.@.@.@.@.@.@ee@@.@...@.@.ee@@e@@.@.@.@...@.@.@.@.w",
        "..e.e.e.e.e.e.e.e.e.e.e.e.e.e.e...e.e...e.e.@.e............@......e..",
        "..e.@.@.@.@.@.@.@.@.@.@.@.@.@.@e..e.e.e.e.@.@.@.@.@.@......e.e@@e@@..",
        "w.@.e.e.e.e.e.e.e.e.e.e.e.e.......@.@.@.@.e.e.e.e.e.e.........e...e.w",
        "..e.@.@.@.@.@.@.e.e.e.e.e.e.e.e.e.e.e.e.e.e.e.e.e.e.e.e.e.@.@.@.@.@..",
        "..e.e.e.e.e.e@e.@.@.@.@.@.@.@.@.@...@.@.@.@.@.@.@.@.@.@.@.e.e.e.e.e..",
        "w.@.@.@.e.e..e....e.e.e.e.e.e.e.e.e.e.e.e.e.e.e.e.e.e.e.e.e.e.e.e.e.w",
        "..e.e.e.@e@.@.@.@.@.@.@.@.@.@.@.@.@.@.@.@.@.@.@.@.@.@.@.@.@.@.@.@.@..",
        "....e.e...e.e.e.e.e.e.e.e.e.e.e.e.e.e.e.e.e.e.e.e.e.e.e.e.e.e.e.e.e..",
        "w.e.@.@.@.@.@.@.@.@.@.@.@.@.@.@.@.@.@.@.@.@...@.@.@.@.@.@.@.@.@.@...w",
        "..@.e.e.e.e.e.e.e.e.e.e.e.e.e............e.e.......@e.e.e.e.e.e.e.e..",
        "..e.@.@.@.@.@.@.@.@.@.@.@.@.@.@.@.@.@.@e.@.@.@e@.@e@........@.@...@..",
        "w.e.e.e.e.e.e.e.e.e.e.e.e.e.e.e.e.e.e.............@.......e.e.e.e.e.w",
        "..@.e.e.e.e.e.e.e.e.e.e.e.e.e.e.e.e.e.e.e.e.e.@.@.@.@.@.@.@.@.@.@.@..",
        "..e.@.@.@.@.@.@.@.@.@.@.@.@.@.@.@.@.@.@.@.@.@.e.e.e.e.e.e.e.e.e.e.e..",
        "w.e.e.e.e.e.e.e.e.e.e.e.e.e.e.e.e.e.e.e.e.e.e.e.e.e.e.@.e.e.e.e.e.e.w",
        "..@.@.@.@.@.@.@.@.@.@.@...@.@.@...@.@.@.@.@.@.@.@.@.@.@.@.@.@.@.@.@..",
        "..e.e.e.e.e.e.e.e.e.e.e.e.e.e.e.e.e.e.e.e.e.e.e.e.e.e.e.e.e.e.e.e.e..",
        "w.e.@.@.@.@.@.@.@.@.@.@.@.@.@.@.@.@.@.@.@.@.@.@...@.@.@.@.@.@.@.@.@.w",
        "..@.e.e.e.e.e.e.e.e.e.e.e.e.e.e.e.e.e.e.e.e.e.e.e.e.e.e.e.e.e.e.e.e..",
        "..e.@.@.@.@.@.@.@.@.@.@.@.@.@.@.@.@.@.@.@.@.@.@.@.@.@.@.@.@.@.@.@.@..",
        "w.e.e.e.e.e.e.e.e.e.e.e.e.e.e.e.e.e.e.e.e.e.e.e.e.e.e.e.e.e.e.e.e.e.w",
        "..@.e.e.e.e.e.e.e.e.e.e.e.e.e.e.e.e.e.e.e.e.e.e.e.e.e.e.e.e.e.e.e.@..",
        "..e.@.@.@.@.@.@.@.@.@.@.@.@.@.@.@.@.@.@.@.@.@.@.@.@.@.@.@.@.@.@.@.@..",
        "w.e.e.e.e.e.e.e.e.e.e.e.e.e.e.e.e.e.e.e.e.e.e.e.e.e.e.e.e.e.e.e.e.e.w",
        "..@.@.@.@.@.@.@.@.@.@.@.@.@.@.@.@.@.@.@.@...@.@.@.@...@.@.@.@.@...@..",
        "..e.e.e.e.e.e.e.e.e.e.e.e.e.e.e.e.e.e.e.e.e.e.e.e.e.e.e.e.e.e.e.e.e..",
        "w.e.@.@.@.@.@.@.@.@.@.@.@.@.@.@.@.@.@.@.@.@.@.@.@.@.@.@.@...@.@.@...w",
        "..@.e.e.e.e.e.e.e.e.e.e.e.e.e.e.e.e.e.e.e.e.e.e.e.e.e.e.e.e.e.e.e.e..",
        "..e.e@e.e@e.e@e.e@e.e@e.@...@.@.@.@.@.@.@.@.@...@e@.@.@.@.@.@.@.@.@..",
        "w....e.e.e.e.e.e.e.e.e.....ee.e.e.e.e.e.e.e.e.e...e.e.e.e.e.e.e.e.e.w",
        "...@.@.@.@.@.@.@.@.@.@.@.@.@e.@e@.@.@.@e..@e@.@...e@@.@.@...@.@.@.@..",
        "...e.e.e.e.e.e.e.e.e.e.e.e.............@.@.e..e...@.......e.e.e.e.e..",
        "w.e.@...@.@.@.@.@.@.@.@.@...@...e@e@e@...e.@......@.@...@.@.@.@.@.@.w",
        "..@@e.@.e.e.e.e.e.e.e.e.e.@.e@@.@.@.@.@.......e.e.e.e.e.e.e.e.e.e.e..",
        "..e.e.e.e.e.e.e.e.e.e.e.e.e.e.e.e.e.e.e.@.@.@.@.@.@.@.@.@...@.@.@.@..",
        "w.e.@.@.@.@.@.@.@.@.@.@.@.@.@.e.e.e.e.e.e.e.e.e.e.e.e.e.e.e.e.e.e.e.w",
        "..@.e.e.e.e.e.e.e.e.e.e.e.e.e.@.@.@.@.@...e.e.e.@.@.@.@.@.@.@.@...@..",
        "..e.@.@.@.@.@.@.@.@.@.@.@...e.e.e.e.e.e...@.@.@.e.e.e.e.e.e.e.e.e.e..",
        "w...e.e.e.e.e.e.e.e.e.e.e.e.@.e.e.e.e.e.e.e.e.e.e.e.@...@.@.@.@.@.@.w",
        "....@.@.@.@...@.@.@.@.@.@.@.@.@.@.@.@.@.@.@.@.@.@.@.e.e.e.e.e.e.e.e..",
        "..e.e.e.e.e.e.e.e.e.e.e.e.e.e.e.e.e.e.e.e.e.e.e.e.e.e.@.@.@.@.@.@.@..",
        "w.@.@.@.@.@.@.@.@.@.@.@.@.....@.@.@.@.@.@.@.@.@.@.@.@.e.e.e.e.e.e.e.w",
        "..e.e.e.e.e.e.e.e.e.e.e.e.e.e.e.e.e.e.e.e.e.e.e.e.e.e.e.e.e.e.e.e.e..",
        "..e.@.@.@.@.@.@.@.@.@.@.@.@.@.@.@.@.@.@.@.@.@.@.@.@...@.@.@.@.@.@.@..",
        "w.@.e.e.e.e.e.e.e.e.e.e.e.e.e.e.e.e.e.e.e.e.e.e.e.e.e.e.e.e.e.e.e.e.w",
        "..e.@.@.@.@.@.@.@.@.@.@.@.@.@.@.@.@.@.@.@...@...@.@.@.@.@.@.@.@......",
        "..e.e.e.e.e.e.e.e.e.e.e.e.e.e.e.e.e.e.e.e.e.e.e.e.e.e.e.e.e.e.e.e.e..",
        "w.@.@.@.@.@.@.@.@.@.@.@.@.@.@.@.@.@.@.@.@.@.@.@...@.@.@.@.@.@...@.@.w",
        "..e.e.e.e.e.e.e.e.e.e.e.e.e.e.e.e.e.e.e.e.e.e.e.e.e.e.e.e.e.e.e.e.e..",
        "..e.e.@.@.@.@.@.@.@.@.@.@.@.@.@.@.@.@.@.@...@.@.@.@.@.@.@.@.@.@.@....",
        "w.@.@.@.e.e.e.e.e.e.e.e.e.e.e.e.e.e.e.e.e.e.e.e.e.e.e.e.e.e.e.e.e.e.w",
        "..e.e.e...........................@.@.@.@.@.@.@.@.@.@.@.@.@.@.@.@e@..",
        "...@...e...@.@.@.@.@.@.@.@.@.@.@.@.@.@.@.@.@.@.@.@.@.@.@.@.@.@.@.@e..",
        "w.@e.@.@...e.e.e.e.e.e.e.e.e.e.e.e.e.e.e.e.e.e.e.e.e.e.e.e.e.e.e.e..w",
        ".....e.e.e.e.e.e.e.e.e.e.e.e.e.e.e.e.e.e.e.e.e.e.e.e.e.e.e.e.e.e.....",
        "..e.@e@@.@.@.@.@.@.@.@.@.@.@.@.@.@.@.@.@.@.@.@.@.@.@.@.@.@.@.@.@.....",
        "w.@.................................................................w",
        "..e@@e@@e@@e@@e@@e@@e@e@@e@e@@e@.@e@e@@e@e@@e@e@@e@e@@e@@e@@e@.@ee@.."
    ],
    "nca_runtime": 0.11757731437683105,
    "milp_runtime": 8.315591096878052,
    "nca_milp_runtime": 8.433168411254883,
    "sim_score": null,
    "weight": false,
    "n_row": 69,
    "n_col": 69,
    "n_endpoint": 1138,
    "n_agent_loc": 0,
    "n_shelf": 1020,
    "maxtime": 5000
}