{
    "name": "kiva_81x80_cma-mae_opt_entropy_uneven_throughput_hamming_a=0",
    "layout": [
        "...e.e.e.@e@@e@@e@@e@@e@@e@e@e@@e@@e@@e@@e@@e@@e.@e@@e@e@@e@@e.e@@e@@e@@e@@e@...",
        "w..@.@.@.......................................................................w",
        "...e.e.e.....................................................................e..",
        "...e.e.e..e@@e@@e@@e@@e@@e@@e@@e@@e@@e@@e@@e@@e@@ee@@e@@e@@e@@e@@e@e@@e@@e@@e@..",
        "w..@.@.@.......................................................................w",
        "...e.e.e.e@@.................................................................e..",
        "...e.e.e.e.e..@e.e@@e@@e@@e.............e@@e@@e@@e@@e@@e@@e@@e@@e@@e@@e@@e@e@@..",
        "w..@.@.@.@.e...................................................................w",
        "...e.e.e.e.@.e@@.............................................................e..",
        ".....e.e.e.e.e.e.@e@@e@@e@@e.e@@e@@e@e@@e@@e@@e@@e....@e@e@@e@@e@@e@@e@@e@@e@@..",
        "w..e.@.@.@.e.@.e...............................................................w",
        "...@.e.e.e.@.e.@.e@@.........................................................e..",
        "...e.e.e.@.e.e.e.e.e.@e@@e@@e@@e@@e@e@@e@e@@e@e@@e@e@@e@@e@....e@@e@@e@@e@@e@@..",
        "w..e.@.@.e.e.@.e.@.e...........................................................w",
        "...@.e.e.e.@.e.@.e.@.e@@.....................................................e..",
        "...e.e.e.@.e.e.e.e.e.e.e.e@@e@@e........@ee@@e@@e@e@@e@@e@@e@@e@@e@@e@@e@@e@.@..",
        "w..e.@.@.e.e.@.e.@.e.@.e.......................................................w",
        "...@.e.e.e.@.e.@.e.@.e.@.e@@.................................................e..",
        "...e.e.e.@.e.e.e.e.e.e.e.e.e.@e@e@e@@e@.@e@@e........e@@e@@e@@e@@e@@e@@ee@@e@@..",
        "w..e.@.@.e.e.@.e.@.e.@.@.@.e...................................................w",
        "...@.e.e.e.@.e.@.e.@.e.e.e.@.e@@.............................................e..",
        "...e.e.e.@.e.e.e.e.e...e.e.e.e.e.@e@.e@@e@@e@e@@e@@e@@e@@e@@e@@e@@e@@e@@e@@e@@..",
        "w..e.@.@.e.e.@.e.@.e.e.@.@.e.@.e...............................................w",
        "...@.e.e.e.@.e.@.e.@.@.e.e.@.e.@.e@@.........................................e..",
        "...e.e.e.@.e.e.e.e.e.e.e.e.e.e.e.e.e.@e@..e@.@e.@e@@e@@e@@e@@e@@e@@e@@e@@e@e@@..",
        "w..e.@.@.e.e.@.e.@.e.e.@.@.e.@.e.@.e...........................................w",
        "...@.e.e.e.@.e.@.e.@.@.e.e.@.e.@.e.@.e@e@@e..@e@@e@@e@@e@@e@@e@@e@@e@@e@@e@@e@..",
        "...e.e.e.@.e.e.e.e.e.e.e.e.e.e.e.e.e.e..........................................",
        "w..e.@.@.e.e.@.e.@.e.e.@.@.e.@.e.@.e.@.e@@e.e@@e@@e@@e@@e@@e@@e@@e@e@@e@@e@@e@.w",
        "...@.e.e.e.@.e.@.e.@.@.e.e.@.e.@.e.@.e.e........................................",
        "...e.e.e.@.e.e.e.e.e.e.e.e.e.e.e.e.e.e.@........................................",
        "w..e.@.@.e.e.@.e.@.e.e.@.@.e.@.e.@.e.@.e..e@.@e@@e@@e@@e@@e@@e@@e@@e@@e@@e@@e@.w",
        "...@.e.e.e.@.e.@.e.@.@.e.e.@.e.@.e.@.e.e........................................",
        "...e.e.e.@.e.e.e.e.e.e.e.e.e.e.e...e.e.@.e....e@@e@@e@@e@@e@@e@@e@@e@@e@@e@@e@..",
        "w..e.@.@.e.e.@.e.@.e.e.@.@.e.@.e.e.e.@.e.@.....................................w",
        "...@.e.e.e.@.e.@.e.@.@.e.e.@.e.@.@.@.e.e.e.e@@e@.@e@@e@@e@@e@@e@e@@e@@e@@e@@e@..",
        "...e.e.e.@.e.e.e.e.e.e.e.e.e.e.e.e.e.e.@.e......................................",
        "w..e.@.@.e...@...@.e.e.@.@.e.@.e.e.e.@.e.@..@e@@e@@e@@e@@e@@e@@e@@e@@e@@e@@e@..w",
        "...@.e.e.e.e.e.e.e.@.@.e.e.@.e.@.@.@.e.e.e......................................",
        "...e.e.e.@.@.e.@.e.e.e.e.e.e.e.e.e.e.e.@.e.@e.e@@e@@e@@e@@e@.@e@@e@@e@@e@e@@e@..",
        "w..e.@.@.e.e.@.e.@.e...@.@.e.@.e.e.e.@.e.@.....................................w",
        "...@.e.e.e...e.e.e.@.e.e.e.@.e.@.@.@.e.e.e..@e@.@e@@e@@e@e@@e@.@e@@e@@e@@ee@e...",
        "...e.e.e.@.e.e.@.e.e.@.e.e.e.e.e.e.e.e.@........................................",
        "w..e.@.@.e.@.@.e.@.e.e.@.@.e.@.e.e.e.@.e.@e@@e@@e@@e@.@e@.@e@@e@@e@e@@e@@e.@e..w",
        "...@.e.e.e.e.e.e.e.@.e.e.e.@.e.@.@.@.e..........................................",
        "...e.e.e.@.e.e.@.e.e.@.e...e.e.e.e.e....e@@e@e...@e@@e..@e@@e@e@@e@@e@e@@e.@e...",
        "w..e.@.@.e.@.@.e.@.e.e.@.e.e.@.e...............................................w",
        "...@.e.e.e.e.e.e.e.@.e.e.@.@.e.@.e.......e@e@@e@@e@@e@.@e@@e@.@e@.@e@@e@@e@@e@..",
        "...e.e.e.@.e.e.@.e.e.@.e.e.e.e.e.@..............................................",
        "w..e.@.@.e.@.@.e.@.e.e.@.e.e.@.e.e.@e@.@e.e@.@e@.@e@@e@@e@@e@..@e@@e@@e@@e..e@.w",
        "...@.e.e.e.e.e.e.e.@.e.e.@.@.e.@................................................",
        "...e.e...@.e.e.@.e.e.@.e.e.e.e.e.@e.@e@@e.e@e@..@e@@e@@e@@e@@e@@e@@e@@e@@e@@e...",
        "w..e.@.e.e.@.@.e.@.e.e.@.e.e.@.................................................w",
        "...@.e.@.e.e.e.e.e.@.e.e.@.@.e.@e.e@e@e@@e@@e@e@.@e@@e@@e@@e@@e@e@@e@@e@@e@@e@..",
        "...e.e.e.@.e.e.@.e.e.@.e.e.e....................................................",
        "w..e.@.e.e.@.@.e.@.e.e.@.e...@e@@e...@e@@e@@e@..e@@e@e@@e@@ee@@e@@e@.@e@@e@@e@.w",
        "...@.e.@.e.e.e.e.e.@.e.e.@......................................................",
        "...e.e.e.@.e.e.@.e.e.@.e.e.@e@@e@@e@.@e@@e@.@e@@e@@e@@e@@e@@e@@e@@e@e@@e@@e@e@..",
        "w..e.@.e.e.@.@.e.@.e.e.@.......................................................w",
        "...@.e.@.e.e.e.e.e.@.e.e.@e@@e@@e@@e@e@e@@e@@ee@..@e@@e@@e@@ee@@e@@e@@e@@e@@e@..",
        "...e.e.e.@.e.e.@.e.e.@..........................................................",
        "w..e.@.e.e.@.@.e.@.e.e.@e@@e@@e@@e@@e@@e@@e@e..e@e@@e@@e@@e@@e@@e@@e@@e@@e@@e@.w",
        "...@.e.@.e.e.e.e.e.@............................................................",
        "...e.e.e.@.e.e.@.e.e.@e@@e@@e@@e@@e@e@@e@@e@..@e.@ee@e@@e@e@@e@@e@@e@@e@@e@@e@..",
        "w..e.@.e.e.@.@.e.@.............................................................w",
        "...@.e.@.e.e.e.e.e.@e@@e@@e@e@@e@@e@e@@e@@e@.@ee@@e.@ee@.@e@@e@@e@@e@@e@@e@@e@..",
        "...e.e.e.@.e.e.@................................................................",
        "w..e.@.e.e.@.@.e.@e@@e@e@@e@@e@e@@e@e@@e@ee@@e@e@e@.@e@@e@e@@e@@e@@e@@e@@e@@e@.w",
        "...@.e.@.e.e.e..................................................................",
        "...e.e.e.@.e...@e@@e@e@@e@e@@e@@e@@e@@e@@e@e@.@e@@e@...@e.e@@e@@e@@e@@e@@e@@e@..",
        "w..e.@.e.e.@...................................................................w",
        "...@.e.@.e.e.@e@@e@@ee@@e@@e.@e@@e@@e@e@@e@@e@...@e@@e@@e.@e@ee@e@@e@@e@@e@e@...",
        "...e.e.e.@......................................................................",
        "w....@.e.e.@e@@e@@e@e@e@@e@..@e@@e@@e@@e@e@@e.e@e@@e@@e@@e@@e@@e@.@e@@e@@e@@e@.w",
        "...e.e.@........................................................................",
        "...@.e.e.@e@@e@@e@@e@@e@@e@@e@e@@e@@e@e@@e@.@e@.@e@@e@@e@@e@@e@@e@@e@@e@@e@@e@..",
        "w..e.@.........................................................................w",
        "...e.e.e@@e@@e@@e@@e@@e@@e@@e@@e@e@@e@@e@.@e@@e@@e@@e@@e@@e..@e@@e@@e@@e@@e@e@..",
        "...@............................................................................",
        "w..e.@e@@e@@e@@e@@e@@e@@e@@e@@e@@e@e@e@@e@@e@.@e@@e@@e@@e@@e@@e@@e@e@@e@@e@@e@.w",
        "................................................................................"
    ],
    "nca_runtime": 0.11191701889038086,
    "milp_runtime": 51.0835223197937,
    "nca_milp_runtime": 51.19543933868408,
    "sim_score": null,
    "weight": false,
    "n_row": 81,
    "n_col": 80,
    "n_endpoint": 1238,
    "n_agent_loc": 0,
    "n_shelf": 1400,
    "maxtime": 5000
}