{
    "name": "kiva_57x58_cma-mae_opt_entropy_uneven_throughput_hamming_a=0",
    "layout": [
        "...e.e.e.@e@@e@@e@@e@@e@@e@e@@e@@e@@e@@e@@e@@e@@e@@e@@e@..",
        "w..@.@.@.................................................w",
        "...e.e.e...............................................e..",
        "...e.e.e.@e@@e@@e@e@@e@@e@@e@@e@@e@@e@@e@e@@e@@e@@e@@e@@..",
        "w..@.@.@.................................................w",
        "...e.e.e.e@@...........................................e..",
        "...e.e.e.e.e.@e@@e@@e@@e@@e@@e@@e@@e@@e@@e@@e@@e@@e@@e@@..",
        "w..@.@.@.@.e.............................................w",
        "...e.e.e.e.@.e@@.......................................e..",
        "...e.e.e.e.e.e.e.@e@@e@@e@@e@@e@@e@@e@@e@e@@e@@e@@e@@e@@..",
        "w..@.@.@.@.e.@.e.........................................w",
        "...e.e.e.e.@.e.@.e@@...................................e..",
        "...e.e.e.e.e.e.e.e.e.e@@e@e@@e@@e@@e@@e@@e@@e@@e@@e@@e@@..",
        "w..@.@.@.@.@.@...@.e.....................................w",
        "...e.e.e.e.e.e.e.e.@.e@@...............................e..",
        "...e.e.e.e.e.e.@.e.e.e.e.@e@@e@@e@e@@e@@e@.@e@@e@@e@@e@@..",
        "w..@.@.@.@.@.@.e.@.e.@.e.................................w",
        "...e.e.e.e.e.e.e.e.@.e.@.e.e@e@@e@@e@@e@@e@@e@@e@@e@.@e@..",
        "...e.e.e.e.e.e.@.e.e.@.e.@.e..............................",
        "w..@.@.@.@.@.@.e.@.e.e.@.e.@.e@e@.@e@@e@e@@e@@e@@e@@e@e@.w",
        "...e.e.e.e.e.e.e.e.@.e.e.@.e.e............................",
        "...e.e.e.e.e.e.@.e.e.@.e.e.e.@.........................e..",
        "w..@.@.@.@.@.@.e.@.e.e.@.e.@.e.@e@@e@@e@@e@@e@@e@@e@@e@@.w",
        "...e.e.e.e.e.e.e.e.@.e.e.@.e.e............................",
        "...@.e.e.e.e.e.@.e.e.@.e.e.@.@.e@@e@@e@@e@@ee@e@@e@@e@e@..",
        "w..e.@.@.@.@.@.e.@.e.e.@.e.e.e.e.........................w",
        "...e.e.e.e.e.e.e.e.@.e.e.@.e.e.@..........................",
        "...@.e.e.e.e.e.@.e.e.@.e.e.@.@.e.@e@@e@@e@@e@@e@@e@@e@e@..",
        "w..e.@.@.@.@.@.e.@.e.e.@.e.e.e...........................w",
        "...e.e.e.e.e.e.e.e.@.e.e.@.e.e@@e@@e@@e@@e@@e@@e@@e@@e@...",
        "...@.e.e.e.e.e.@.e.e.@.e.e.@..............................",
        "w..e.@.@.@.@.@.e.@.e.e.@.e.e.@e@@e@@e@@e@@e@@e@@e@@e@@e@.w",
        "...e.e.e.e.e.e.e.e.@.e.e.@................................",
        "...@.e.e.@.e...@.e.e.@.e.e.@e@@e@@e@@e@@e@@e@@e@@e@@e@@e..",
        "w..e.@.@.e.@.e.e.@.e.e.@.................................w",
        "...e.e.e.e.e.@.e.e.@.e.e.@e@@e@@e@@e@@e@@e@@e@@e@@e@e@@e..",
        "...@.e...@.e.e.@.e.e.@....................................",
        "w..e.@.e.e.@.e.e.@.e.e.@ee@@ee@@e@@e@@e@e@@e@@ee@@e@e@@e.w",
        "...e.e.@.e.e.@.e.e.@......................................",
        "...@.e.e.@.e.e.@.e.e.e@@e@@ee@@e@@e@@e@@ee@@ee@@e@@e@@e@..",
        "w..e.@.e.e.@.e.e.@.......................................w",
        "...e.e.@.e.e.@.e.e.e@@e@@e@@e@@e@.e@@ee@.@e.@e@@e@e@@e@...",
        "...@.e.e.@.e.e.@..........................................",
        "w..e.@.e.e.@.e.e.@e.@e@.@e@@e@.e@..e@...e@e@@e@@e@@e@@e@.w",
        "...e.e.@.e.e.@............................................",
        "...@.e.e.@.e.e.e@@e....@e@@ee@@e@@e@@e@@e@@ee@@e@e@@e.@e..",
        "w..e.@.e.e.@.............................................w",
        "...e.e.@.e.e..@e@@ee@.@e@@e@e@@e.e@@e@@e@e@@e@.@e@@ee@e@..",
        "...@.e.e.@................................................",
        "w..e.@.e.e....e@@ee@@e@@e@@e@e@@e@@e@e@@e@e@e@@e@@e@@ee@.w",
        "...e.e.@..................................................",
        "...@.e.e.@e@@e@@e.e@@e.e@....@e@@e@@e@@e@@ee@@e@@ee@@ee@..",
        "w..e.@...................................................w",
        "...e.e..@e@.@e@.@e@..@e@@ee@...e@@e@@ee@@e@@e@@e@.@e@@e@..",
        "...@......................................................",
        "w..e...@e@@e.e@@ee@@e@e@@e@@e..@e@e@e@e@@ee@@e@@e..@e@@e.w",
        ".........................................................."
    ],
    "nca_runtime": 0.1000208854675293,
    "milp_runtime": 5.548733711242676,
    "nca_milp_runtime": 5.648754596710205,
    "sim_score": null,
    "weight": false,
    "n_row": 57,
    "n_col": 58,
    "n_endpoint": 635,
    "n_agent_loc": 0,
    "n_shelf": 700,
    "maxtime": 5000
}