{
    "name": "kiva_45x47_cma-mae_opt_entropy_throughput_hamming_a=5",
    "layout": [
        "...............................................",
        "w.e@@ee@@ee@@ee@@ee@@ee@@ee@@ee@@e..@ee@@e.e@.w",
        "...............................................",
        "..e@@ee@@ee@@ee@@ee@@ee@@ee@@ee@@ee@@ee@.e@e...",
        "w.............................................w",
        "..e@e.e@@ee@@ee@@ee@@ee@@ee@@ee@@ee@@ee@@e.e@..",
        "...............................................",
        "w.e@@ee@@ee@@ee@@ee@@ee@@ee@@ee@@ee@@ee@@ee@..w",
        "...............................................",
        "..e@@ee@@ee@@ee@@ee@@ee@@ee@@ee@@ee@@ee@@ee@e..",
        "w.............................................w",
        "..e@@ee@@ee@@ee@@ee@@ee@@ee@..e@@ee@@ee@@e.e@..",
        "...............................................",
        "w.e@@ee@@ee@@ee@@ee@@ee@@ee@..e@@ee@@ee@@ee@..w",
        "...............................................",
        "..e@@ee@@ee@@ee@..e@@ee@@ee@@ee@@ee@@ee@@ee@e..",
        "w.............................................w",
        "..e@@ee@..e@@ee@@ee@@ee@@ee@@ee@@ee@@ee@@e.e@..",
        "...............................................",
        "w.e@@ee@@ee@@ee@@ee@@ee@@ee@@ee@@ee@@ee@@ee@e.w",
        "...............................................",
        "..e@@ee@@ee@@ee@@ee@@ee@@ee@..e@@ee@@ee@@ee@e..",
        "w.............................................w",
        "..e@@ee@@ee@@ee@@ee@@ee@@ee@@ee@@ee@@ee@@e.e@..",
        "...............................................",
        "w.e@@ee@@ee@@ee@@ee@@ee@@ee@@ee@@ee@@ee@@ee@..w",
        "...............................................",
        "..e@@ee@@ee@@ee@@ee@@ee@@ee@@ee@@ee@@ee@@ee@e..",
        "w.............................................w",
        "..e@@ee@@ee@@ee@@ee@@ee@@ee@@ee@@ee@@ee@@e.....",
        "...............................................",
        "w.e@@ee@@ee@@ee@@ee@@ee@@ee@@ee@@ee@@ee@@ee@..w",
        "...............................................",
        "....@ee@@ee@@ee@@ee@@ee@@ee@@ee@@ee@@ee@@ee@e..",
        "w.............................................w",
        "..e@@ee@@ee@@ee@@ee@@ee@@ee@..e@@ee@@ee@@e.e@..",
        "...............................................",
        "w...@ee@@ee@@ee@@ee@@ee@@e..@ee@@ee@@ee@@ee@..w",
        "...............................................",
        "......e@@ee@@ee@@ee@@ee@@ee@@ee@@ee@@ee@@ee@e..",
        "w.............................................w",
        "..e@....@ee@@ee@@ee@@ee@@ee@@ee@@ee@@ee@@e.e@..",
        "...............................................",
        "w.e@@ee@@ee@....@e....e@@e..@ee@@ee@@ee@@ee@e.w",
        "..............................................."
    ],
    "nca_runtime": 0.10213065147399902,
    "milp_runtime": 4.046552419662476,
    "nca_milp_runtime": 4.148683071136475,
    "sim_score": null,
    "weight": false,
    "n_row": 45,
    "n_col": 47,
    "n_endpoint": 450,
    "n_agent_loc": 0,
    "n_shelf": 440,
    "maxtime": 5000
}