{
    "name": "kiva_69x69_cma-mae_opt_entropy_throughput_hamming_a=1",
    "layout": [
        ".....................................................................",
        "w.e@@e@@e@@e@@e@@e@@e@@e@@e@@e@@e...e@@e@@e@@e@@e@@e@@ee@@e@@e@e@@e.w",
        ".....................................................................",
        "..e@@e.e@e@@e@e@@ee@@e@@e@@e@.@e@@ee@@e@@e@@e@@e@@e@@e@@e@@e@@e@@e...",
        "w...................................................................w",
        "....@e..e@@e@@e@@e@@e@.@e@@e@@e@@e@@e...e@@e@.e@@e@@e@@e@@e@@e.@ee@..",
        ".....................................................................",
        "w.@e@.e@@ee@@e@@e..e@@e.e@@e@@e.e@..e@@e@ee@@e@@e@e@@ee@@e@@e@@e@...w",
        ".....................................................................",
        "..@e@@e@@e@@e.e@@ee@ee@ee@ee@ee@ee@ee@ee@ee@ee@ee@ee@ee@e.e@ee@ee@e..",
        "w...................................................................w",
        "......e@@e..@e@@e@@e@@e@@e@@e@@e@@e@@e@@e@ee@ee@@e@@e@@e@@e@@e@@e@...",
        ".....................................................................",
        "w.e@@e@@e@e@@e@@e@@e@@e@e@@e@@e@@e@@e@@e@e@@e@e@@e@@e@@e@@e@@e@@e@..w",
        ".....................................................................",
        "..@e@.@e@@e@@e@.e@@e@@e@@e@@ee@@e@@e@@e@.e@@ee@@e@.@e@@e..e@@e@@e....",
        "w...................................................................w",
        "..e@@e@@e@@e@@e@@e@@e@@e@@e@@ee@@e@@e@e@@e@@e@@e@@e@e@@e@@e@@e@@e@...",
        ".....................................................................",
        "w.e@@ee@@e@@e@@ee@@e@@e@@e@@e@@e@e@.e@@e@@e@@e@e@e@@e@@e@@e@@e@@e@e.w",
        ".....................................................................",
        "...e@e@@ee@@e..e@@e@@e@@e@@e@@e@@e@@e@@e@@e@@e@@e@@e@@ee@@e@@e@@e@...",
        "w...................................................................w",
        "..@e@@e@@e@@e@@e@@e@@e@@e@@e@@e@@e@.e@@e@@e@e.e@@e@@e@@e@@e@@e@@e@...",
        ".....................................................................",
        "w.e@ee@ee@@e@e@@e@e@e@@e@@e@e@@e@@e@@e@@e.@e@@e@@e@@e@@e@@e@.@e@@e@.w",
        ".....................................................................",
        "...e@ee@ee@ee@@e@@e@@e@@e@@e@@e@@e@@e@@e@@e@.e@@e@e@@e@@e@@e@@e@@e@..",
        "w...................................................................w",
        "..e@ee@ee@ee@ee@ee@e@ee@ee@ee@ee@ee@ee@ee@ee@ee@ee@ee@ee@ee@ee@ee@e..",
        ".....................................................................",
        "w.e@ee@ee@ee@ee@ee@ee@@e@@e@@e@@e@@e@@e@@e@.@e...e@@e@@e@@e@@e@@e@..w",
        ".....................................................................",
        "..e@ee@ee@ee@ee@ee@eee@@e@@e@@e@.e@@e@@e@@e@@e@@e@@e@@e@@e@@e@@e@@e..",
        "w...................@...............................................w",
        "..e@ee@ee@ee@ee@ee@eee@..e@@e@@e@@e@@e@@e@e@@e@@e@@e@@e@@e@@e@@e@e@..",
        ".....................................................................",
        "w.e@ee@ee@ee@ee@ee@ee@ee@ee@ee@ee@e.e@ee@ee@ee@ee@e.e@ee@ee@ee@ee@e.w",
        ".....................................................................",
        "...e@ee@ee@ee@ee@ee@@e@.@e@@e@@e@@e@@e@@e@@e@@e@@e@@e@ee@@e@@e@@e@...",
        "w...................................................................w",
        "...e@ee@ee@ee@ee@ee@ee@ee@ee@ee@ee@ee@ee@ee@ee@ee@ee@ee@e.e@ee@ee@e..",
        ".....................................................................",
        "w..e@ee@ee@ee@ee@ee@ee@ee@ee@ee@e.e@ee@ee@ee@ee@ee@ee@ee@ee@ee@ee@e.w",
        ".....................................................................",
        "..e@ee@ee@ee@ee@ee@ee@ee@ee@ee@e.e@ee@ee@ee@ee@ee@ee@ee@ee@ee@eee@e..",
        "w..............................................................@....w",
        "...e@ee@ee@ee@ee@ee@ee@ee@ee@ee@ee@ee@ee@ee@ee@ee@ee@ee@ee@ee@eee@e..",
        ".....................................................................",
        "w.e@ee@eee@ee@e.e@ee@@e@@e..e@@e@@e@@e@@e@@e@@e@@e@e@.@e@@e@@e@@ee@.w",
        "........@............................................................",
        "..e@ee@eee@ee@ee@ee@ee@@e@..e@@e@@ee@@ee@@e@@e@@e@e@@e@@e@@e@@e@e@...",
        "w...................................................................w",
        "..e@ee@ee@eee@ee@ee@ee@ee@ee@ee@ee@ee@ee@ee@ee@ee@ee@ee@ee@ee@eee@e..",
        "...........@...................................................@.....",
        "w.e@ee@ee@eee@ee@ee@ee@ee@ee@ee@ee@ee@ee@ee@ee@ee@ee@ee@ee@ee@eee@e.w",
        ".....................................................................",
        "...e@ee@ee@ee@ee@ee@ee@eee@ee@ee@ee@ee@ee@ee@ee@ee@ee@ee@ee@ee@ee@e..",
        "w.......................@...........................................w",
        "..e@ee@ee@ee@ee@ee@eee@eee@ee@ee@ee@ee@ee@ee@ee@ee@ee@ee@ee@ee@ee@e..",
        "....................@................................................",
        "w.e@ee@ee@ee@ee@ee@eee@ee@ee@ee@ee@ee@ee@ee@ee@ee@ee@eee@ee@ee@ee@e.w",
        "......................................................@..............",
        "..e@ee@ee@ee@ee@ee@ee@ee@ee@ee@ee@ee@ee@e.e@ee@ee@ee@eee@ee@ee@ee@e..",
        "w...................................................................w",
        "..e@ee@ee@ee@ee@ee@ee@ee@ee@eee@ee@ee@e.e@ee@ee@ee@ee@ee@ee@ee@ee@e..",
        ".............................@.......................................",
        "w.e@ee@ee@ee@ee@ee@ee@ee@ee@eee@ee@e.e@ee@ee@ee@ee@ee@ee@ee@ee@ee@e.w",
        "....................................................................."
    ],
    "nca_runtime": 0.1048896312713623,
    "milp_runtime": 169.8840630054474,
    "nca_milp_runtime": 169.98895263671875,
    "sim_score": null,
    "weight": false,
    "n_row": 69,
    "n_col": 69,
    "n_endpoint": 1113,
    "n_agent_loc": 0,
    "n_shelf": 1020,
    "maxtime": 5000
}