{
    "name": "kiva_45x47_cma-mae_opt_entropy_throughput_hamming_a=1",
    "layout": [
        "...............................................",
        "w.@e@@e@@e@@e@@e@@e@@e@@e@@e@@e@@e@@e@@e@@e@..w",
        "...............................................",
        "..@e@@e@@e@@e@@e@@e@@e@@e@@e@@e@@e@@e@@e@@e@...",
        "w.............................................w",
        "..@e@@e@@e@@e@@e@@e@@e@@e@@e@@e@@e@@e@@e@@e@...",
        "...............................................",
        "w.@e@@e@@e@@e@@e@@e@@e@@e@@e@@e@@e@@e@@e@@e@..w",
        "...............................................",
        "..e@ee@ee@ee@e.e@ee@ee@ee@ee@ee@ee@ee@ee@ee@e..",
        "w.............................................w",
        "..@e@@e@@e@@e@@e@@e@@e@@e@@e@@e@@e@@e@@e@@e@e..",
        "...............................................",
        "w.@e@@e@@e@@e@@e@@e@@e@@e@@e@@e@@e@@e@@e@@e@..w",
        "...............................................",
        "..@e@@e@@e@@e@@e@@e@@e@@e@@e@@e@@e@@e@@e@@e@...",
        "w.............................................w",
        "..@e@@e@@e@@e@@e@@e@@e@@e@@e@@e@@e@@ee@@e@@e@..",
        "...............................................",
        "w.e@eee@ee@ee@ee@ee@ee@ee@ee@ee@ee@ee@ee@ee@e.w",
        ".....@.........................................",
        "..e@eee@ee@ee@ee@ee@ee@ee@ee@ee@ee@ee@ee@ee@e..",
        "w.............................................w",
        "..@e@@e@@e@@e@@e@@e@@e@@e@@e@@e@@e@@e@@e@@e@...",
        "...............................................",
        "w.e@ee@eee@ee@ee@ee@ee@ee@ee@ee@ee@ee@ee@ee@e.w",
        "........@......................................",
        "..e@ee@eee@ee@ee@ee@ee@ee@ee@ee@ee@ee@ee@ee@e..",
        "w.............................................w",
        "..e@ee@ee@ee@ee@ee@ee@ee@ee@ee@eee@ee@ee@ee@e..",
        "................................@..............",
        "w.e@ee@ee@ee@ee@ee@ee@ee@ee@ee@eee@ee@ee@ee@e.w",
        "...............................................",
        "..e@ee@ee@ee@ee@ee@ee@ee@ee@eee@ee@ee@ee@ee@e..",
        "w............................@................w",
        "..e@ee@ee@ee@ee@ee@ee@ee@ee@eee@ee@ee@ee@ee@e..",
        "...............................................",
        "w.e@ee@ee@ee@ee@ee@ee@ee@ee@eee@ee@ee@ee@ee@e.w",
        ".............................@.................",
        "..e@ee@ee@ee@ee@ee@ee@ee@ee@eee@ee@ee@ee@ee@e..",
        "w.............................................w",
        "..e@ee@ee@ee@ee@ee@ee@ee@ee@ee@ee@ee@ee@eee@e..",
        ".........................................@.....",
        "w.e@ee@ee@ee@ee@ee@ee@ee@ee@ee@ee@ee@ee@eee@e.w",
        "..............................................."
    ],
    "nca_runtime": 0.10285711288452148,
    "milp_runtime": 13.18612790107727,
    "nca_milp_runtime": 13.288985013961792,
    "sim_score": null,
    "weight": false,
    "n_row": 45,
    "n_col": 47,
    "n_endpoint": 504,
    "n_agent_loc": 0,
    "n_shelf": 440,
    "maxtime": 5000
}