{
    "name": "kiva_45x47_cma-mae_opt_entropy_uneven_throughput_hamming_a=1",
    "layout": [
        "...............................................",
        "w.e@e@e@e@e.e@e@e.e@e@e@e@...e@..@e@..e@@e@e@.w",
        "...............................................",
        "..e@e@e@e@e@e@e@e@e@e@e@e@@ee@@e@e@.@e.@e@@e@..",
        "w.............................................w",
        "..e@e@e@e@e@e@e@e@e@e@e@e@e@@e@e@@e@.@e@e@@e@..",
        "...............................................",
        "w.e@e@e@e@e@e@e@e@e@e@..@e.e@ee@e@e@e@e@e@@e@.w",
        "...............................................",
        "..e@e.e@e@e@.@ee@e@....e@e@e@..@e@e@e@e@e@@e@..",
        "w.............................................w",
        "..e@e@...@e.@e@e@e@e@e@e@e@e@e@e@@e@e@e@e@ee@..",
        "...............................................",
        "w.e@ee@@e.@e@e@e@e@e@e@e@e@e@e@@e@e@e@e@e@e@..w",
        "...............................................",
        "..e@e....e@e.e@e@e@e@e@e@e@e@e@@e@e@e@e@e@ee@..",
        "w.............................................w",
        "..e@e@@e@e.e@e@e@e@e@e@e@e@e@e@@e@e@e@e@ee@@e..",
        "...............................................",
        "w.e@e@e@@e@e@e@e@e@e@e@ee@e@@e@e@e@e@@e@e@ee@.w",
        "...............................................",
        "..e@..@e@e@e@e@e@e@e@e@e@e@e@e@e.e@e@@e.e@ee@..",
        "w.............................................w",
        "..e@e@@e@e@e@e@e@e@...@e@e.e@e@e@e@..@e@e@e@...",
        "...............................................",
        "w.e@.....@ee@@e..@e@e@@e@e@e@e@e@...e@e@e@e@..w",
        "...............................................",
        "..e@e@..e@@e@.e@@ee@e@e@@e@e.e@e@..@e@e@e@e@...",
        "w.............................................w",
        "..e@e@e@e@e@e@e@e@e@e@e@.@ee@e@e@.e@e@e@e@e@e..",
        "...............................................",
        "w.e@e@e@e.e@e@e@e@e@e@@e@e@.@ee@e@e@e@e@e@e@..w",
        "...............................................",
        "..e@e@e@e@..@e@@e@e@e@@e@e@e.@e@e@e@e@e@e@e@e..",
        "w.............................................w",
        "..e@e@e.e@e@e@e@e@e@e@@e@e@e@..@e@e@e.e@e@e@e..",
        "...............................................",
        "w.e@e.e@e@e@e@e@e@e@@e@e@e@ee@@ee@@ee@e@e@e@e.w",
        "...............................................",
        "..e@e@e@e@e@e@e@e@e@e@@e@e@e@e@e@@e@e@e@e@e@...",
        "w.............................................w",
        "..e@e@e@e@e@e@e@e@e@@e@e@e.e@e@e@ee@e@e@.@e@...",
        "...............................................",
        "w.e@e@e@e@e@e@e@e@e@@e@e.e@e@e@e@e@.@e@@e@@e@.w",
        "..............................................."
    ],
    "nca_runtime": 0.10222291946411133,
    "milp_runtime": 3.790972948074341,
    "nca_milp_runtime": 3.893195867538452,
    "sim_score": null,
    "weight": false,
    "n_row": 45,
    "n_col": 47,
    "n_endpoint": 423,
    "n_agent_loc": 0,
    "n_shelf": 440,
    "maxtime": 5000
}