{
    "name": "kiva_57x58_cma-mae_opt_entropy_throughput_hamming_a=1",
    "layout": [
        "..........................................................",
        "w.e@@e@@e@@e@@e@@e@@e@@e@@e@@e@@e@@e@e@@e@@e@@e@@e@@e@@e.w",
        "..........................................................",
        "..@e@@e@@e@@e@@e@@e@@e@@e@@e@@e@@e@e@e@@e@@e@@e@@e.e@@e@..",
        "w........................................................w",
        "....@e@@e@e@@e@@e@@e@.....@e@@e@@e.@e@@e@@e@@e@@e@@e@e@...",
        "..........................................................",
        "w..@e@@e@@e@@e@@e@@e@@e@@e@@e@@e@..e@@e@@e@@e@@e@@ee@@e..w",
        "..........................................................",
        "..@e@@ee@ee@ee@ee@ee@ee@ee@ee@ee@e.e@ee@ee@ee@ee@ee@ee@e..",
        "w........................................................w",
        "..@e.e@@e@@e@@e@@e@@e@@e@@e@e@@ee@@e@@e@@e@@e@@e@@e@@e@...",
        "..........................................................",
        "w..e@@e@@ee@@e@@e@e@@e@..e@@ee@@e@@e@@e@@e@@e@@e@@e@@e@..w",
        "..........................................................",
        "...e@@e@@e@@e@@e@@e@@e@@e..@e@@e@@ee@@e@e@@e@.@e@@e@@e@...",
        "w........................................................w",
        "..e@@e@@e@@e...e@@e@@e@@e@@e@@e@@e@@e@@e@@e@@e@@e@@e@@e...",
        "..........................................................",
        "w..@e@@e@@e@@e...@e@@e@@e@@e@@e@@e@@e@@ee@@e@@e@@e@@ee@e.w",
        "..........................................................",
        "..e@@e@@e@@e@@e@e@@e@@e@@e@@e@@e@e@e@@e@@e@@e@@e@@e@@e@...",
        "w........................................................w",
        "..e@e@e@@e@@e@@e@@e@@e@@e@@e@@e@@e@@e@@e@@e@@e@@e@@e@@e...",
        "..........................................................",
        "w.e@e@e@@e@@e@@e@@e@@ee@@e@...@e@@e@@e@@e@@e@@e@@e@@e@...w",
        "..........................................................",
        "..e@ee@ee@ee@ee@ee@ee@ee@ee@ee@ee@ee@ee@ee@ee@ee@ee@ee@e..",
        "w........................................................w",
        "..e@ee@ee@ee@ee@ee@ee@ee@ee@ee@ee@ee@ee@ee@ee@ee@ee@ee@e..",
        "..........................................................",
        "w.e@ee@ee@ee@ee@ee@ee@ee@ee@ee@ee@ee@ee@ee@ee@ee@ee@ee@e.w",
        "..........................................................",
        "..e@ee@ee@ee@ee@ee@ee@ee@ee@ee@ee@ee@ee@ee@ee@ee@ee@ee@e..",
        "w........................................................w",
        "..e@ee@ee@ee@ee@ee@ee@ee@ee@ee@ee@ee@ee@ee@ee@ee@ee@ee@e..",
        "..........................................................",
        "w.e@ee@ee@e@@e.e@.@e@@e@@e@@e@.@ee@@e@@e@@ee@@e@.@e@@e@..w",
        "..........................................................",
        "..@ee@ee@ee@@e@@e@@e@@e@@e@@e@@e@@e@@e@@e@@e@@e@@e@@e@....",
        "w........................................................w",
        "..e@ee@ee@ee@ee@ee@ee@ee@ee@ee@ee@ee@ee@ee@ee@ee@ee@ee@e..",
        "..........................................................",
        "w.e@ee@ee@ee@ee@ee@ee@ee@ee@ee@ee@ee@ee@ee@ee@ee@ee@ee@e.w",
        "..........................................................",
        "..e@ee@ee@ee@ee@ee@ee@ee@ee@ee@ee@ee@ee@ee@ee@ee@ee@ee@e..",
        "w........................................................w",
        "..e@ee@ee@ee@ee@ee@ee@ee@ee@ee@ee@ee@ee@ee@ee@ee@ee@ee@e..",
        "..........................................................",
        "w.e@ee@ee@ee@ee@ee@ee@ee@ee@ee@ee@ee@ee@ee@ee@ee@ee@ee@e.w",
        "..........................................................",
        "..e@ee@ee@ee@ee@ee@ee@ee@ee@ee@ee@ee@ee@ee@ee@ee@ee@ee@e..",
        "w........................................................w",
        "..e@ee@ee@ee@ee@ee@ee@ee@ee@ee@ee@ee@ee@ee@ee@ee@ee@ee@e..",
        "..........................................................",
        "w.e@ee@ee@ee@ee@ee@ee@ee@ee@ee@ee@ee@ee@ee@ee@ee@ee@ee@e.w",
        ".........................................................."
    ],
    "nca_runtime": 0.1100606918334961,
    "milp_runtime": 18.328871488571167,
    "nca_milp_runtime": 18.438932180404663,
    "sim_score": null,
    "weight": false,
    "n_row": 57,
    "n_col": 58,
    "n_endpoint": 764,
    "n_agent_loc": 0,
    "n_shelf": 700,
    "maxtime": 5000
}