{
    "name": "kiva_93x91_cma-mae_opt_entropy_uneven_throughput_hamming_a=5",
    "layout": [
        "...e.......................................................................................",
        "w..@.@.@.@.@.@.@.@.@.@.@.@.@.@.@.@.@.@e@@.@.@.@.@.@.@.@.@.@.@.@.@.@e@@.@.@.@.@.@.@.@.@@e@.w",
        "...e.e.e.e.e.e.e.e.e.e.e.e.e.e.e.e.e.e..e.e.e.e.e.e.e.e.e.e.e.e.e.e..e.e.e.e.e.e.e.e.e@....",
        "...e@e.e.e.e.e@e.e.e.e.e.e.e.e.e...........................................................",
        "w..e.e.@.@.@.e.e.@.@.@.@.@.@.@.@@e@@e@@e@@e@@@@@@@@@@@e@@e@@@@@@@@@@@@@@@@@@@@@@@@@@@@@@@.w",
        "...@.@.e.e.e.@.@.e.e.e.e.e.e.e.e............eeeeeeeee......eeeeeeeeeeeeeeeeeeeeeeeeeeeeee..",
        "...e.e.e.e.e.e.e.e@e.e.e.e.e.e.e.@e@@e@@e@@@@@@@@@@@@@@@@@@@@@@@@@@@@@@@@@@@@@@@@@@@@@@@@..",
        "w..e.e.@.@.@.e.e.e.e.@.@.@.@.@.@.e.e......ee....e....eeeeee...............................w",
        "...@.@.e.e.e.@.@.@.@.e.e.e.e.e.e.e.e.@e@@@@@@e@@@@e@@@@@@@@@@@@@@@@@@e@@@@@@@@@@@@@@@@@@@..",
        "...e.e.e.e.e.e.e.e.e.e.e.e.e.e.e.@.@.e..ee.....e....e......eeeeeeeee...eeeeeeeeeeeeeeeeee..",
        "w..e.e.@.@.@.e.e.e.e.@.@.@.@.@.@.e.e.e.@@@@@e@@@@e@@@@@@e@@@@@@@@@@@@@@@@@@@@@@@@@@@@@@@@.w",
        "...@.@.e.e.e.@.@.@.@.e.e.e.e.e.e.e.e.@.e..e...e....e.ee...e.........eee....................",
        "...e.e.e.e.e.e.e.e.e.e.e.e@e.e@e.@.@.e.e.@@@@@@@e@@@@@@@@@@@e@@@@@@@@@@@@@@@@@@@@@@@@@@@@..",
        "w..e.e.@.@.@.e.e.e.e.@.@.e.e.e.e.e.e.e.@.e.eee....e.e..eee....eeeeee...eeeeeeeeeeeeeeeeee.w",
        "...@.@.e.e.e.@.@.@.@.e.e.@.@.@.@.e.@.@.e.e.@@@@@@@@@@@@@@@@e@@@@@@@@@@@@@@@@@@@@@@@@@@@@@..",
        "...e.e.e.e.e.e.e.e.e.e.e.e.e.e.e.@.e.e.e.@.e..eeee.e.ee......e......eee....................",
        "w..e.e.@.@.@.e.e.e.e.@.@.e.e.e.e.e.e.e.@.e.e.@@@@@@@@@@@@e@@@@@@@@@@@@@@e@@@@e@@@@@@@@@@@.w",
        "...@.@.e.e.e.@.@.@.@.e.e.@.@.@.@.e.@.@.e.e.@.e....e.ee.e...ee.eeeeee......ee..eeeeeeeeeee..",
        "...e.e.e.e.e.e.e.e.e.e.e.e.e.e.e.@.e.e.@.@.e.@.@.@@@@@@@@@@@@@@@@@@@@@@@@@@@@@@@@@@@@@@@@..",
        "w..e.e.@.@.@.e.e.e.e.@.@.e.e.e.e.e.e.e.e.e.e.e.e.e.e..e.eee..e......eeeeee..ee............w",
        "...@.@.e.e.e.@.@.@.@.e.e.@.@.@.@.e.@.@.e.e.@.e.e.e.@.@@@@.@.@@@@@@e@@@@@@@@@@@@@@@@@@@@@@..",
        "...e.e.e.e.e.e.e.e.e.e.e.e.e.e.e.@.e.e.@.@.e.@.@.@.e.e.e..e.e.eee.......e.ee..eeeeeeeeeee..",
        "w..e.e.@.@.@.e.e.e.e.@.@.e.e.e.e.e.e.e.e.e.e.e.e.e.e@e.@.@e.e.@@@@@@e@@@@@@@@@@@@@@@@@@@@.w",
        "...@.@.e.e.e.@.@.@.@.e.e.@.@.@.@.e.@.@.e.e.@.e.e.e.e.e.e.e..@.e..ee...ee.e..ee.............",
        "...e.e.e.e.e.e.e.e.e.e.e.e.e.e.e.@.e.e.@.@.e.@.@.@.@.@.e.@..e.@.@@@@@@@@@@@@@@@@@@@@@@@@@..",
        "w..e.e.@.@.@.e.e.e.e.@.@.e.e.e@e.e.e.e.e.e.e.e.e.e.e.e.@.e.e..e.e..eee..e.ee..eeeeeeeeeee.w",
        "...@.@.e.e.e.@.@.@.@.e.e.@.@.e.e.e.@.@.e.e.@.e.e.e.e.e.e.e.@..e.@.@@@@@@@@@@@@@@@@@@@@@@@..",
        "...e.e.e.e.e.e.e.e.e.e.e.e.e.@.@.@.e.e.@.@.e.@.@.@.@.@.e.@.e.e@.e.e...ee.e..ee.............",
        "w..e.e.@.@.@.e.e.e.e.@.@.e.e.e.e.e.e@e.e.e.e.e.e.e.e.e.@.e.e.@.@..@.@@@@@@@@@@@@@@@@@@@@@.w",
        "...@.@.e.e.e.@.@.@.@.e.e.@.@.e.e.e.e.e.e.e.@.e.e.e.e.e.e.e.@.e.e.e..ee..e.ee..eeeeeeeeeee..",
        "...e.e.e.e.e.e.e.e.e.e.e.e.e.@.@.@.@.@.@.@.e.@.@.@.@.@.e.@.e.e.e.@.@.@@@@@@@@@@@@@@@@@@@@..",
        "w..e.e.@.@.@.e.e.e.e.@.@.e.e.e.e.e.e.e.e.e.e.e.e.e.e.e.@.e.e.@.@.e.e..ee.e..ee............w",
        "...@.@.e.e.e.@.@.@.@.e.e.@.@.e.e.e.e.e.e.e.@.e.e.e.e.e.e.e.@.e.e.e.@.@@@@@@@@@@@e@.@.@.@...",
        "...e.e.e.e.e.e.e.e.e.e.e.e.e.@.@.@.@.@.@.@.e.@.@.@.@.@.e.@.e.e.e.@.e.e..e.ee..e..e.e.e.e...",
        "w..e.e.@.@.@.e.e.e.e.@.@.e.e.e.e.e.e.e.e.e.e.e.e.e.e.e.@.e.e.@.@.e.e.e.@@@@@@@@@@@.@.@.@..w",
        "...@.@.e.e.e.@.@.@.@.e.e.@.@.e.e.e.e.e.e.e.@.e.e.e.e.e.e.e.@.e.e.e.@.@.e.e..ee.ee..e.e.e...",
        "...e.e.e.e.e.e.e.e.e.e.e.e.e.@.@.@.@.@.@.@.e.@.@.@.@.@.e.@.e.e.e.@.e.e.e.@e@@@@@@@.@.@.@...",
        "w..e.e.@.@.@.e.e.e.e.@.@.e.e.e.e.e.e.e.e.e.e.e.e.e.e.e.@.e.e.@.@.e.e@e.@.e.e..e..e.e.e.e..w",
        "...@.@.e.e.e.@.@.@.@.e.e.@.@.e.e.e.e.e.e.e.@.e.e.e.e.e.e.@.@.e.e.e.e.e.e.e.@.@@@.@.@.@.@...",
        "...e.e.e.e.e.e.e.e.e.e.e.e.e.@.@.@.@.@.@.@.e.@.@.@.@.@.e.e.e.e.e.@.@.@.e.@.e.e.e.e.e.e.e...",
        "w..e.e.@.@.@.e.e.e.e.@.@.e.e.e.e.e.e.e.e.e.e.e.e.e.e.e.@.e.e.@.@.e.e.e.@.e.e.e.e.@.@.@.@..w",
        "...@.@.e.e.e.@.@.@.@.e.e.@.@.e.e.e.e.e.e.e.@.e.e.e.e.e.e.@.@.e.e.e.e.e.e.e.@.@.@.e.e.e.e...",
        "...e.e.@.e.e.e.e.e.e.e.e.e.e.@.@.@.@.@.@.@.e.@.@.@.@.@.e.e.e.e.e.@.@.@.e.@.e.e.e.e.e.e.@...",
        "w..e.e.e.@.@.e.e.e.e.@.@.e.e.e.e.e.e.e.e.e.e.e.e.e.e.e.@.e@e.@.@.e.e.e.@.e.@.e@e.@.@.@.e..w",
        "...@.@.e.e.e.@.@.@.@.e.e.@.@.e.e.e.e.e.e.e.@.e.e.e.e.e.e.e.e.e.e.e.e.e.e.e.e.e.e.e.e.e.e...",
        "...e.e.@.e.e.e.e.e.e.e.e.e.e.@.@.@.@.@.@.@.e.@.@.@.@.@.e.@.@.e.e.@.@.@.e.@.e.@.@.e.e.@.@...",
        "w..e.e.e.@.@.e.e.e.e.@.@.e.e.e.e.e.e.e.e.e.e.e.e.e.e.e.@.e.e.@.@.e.e.e.@.e.@.e.e.@.@.e.e..w",
        "...@.@.e.e.e.@.@.@.@.e.e.@.@.e.e.e.e.e.e.@.@.e.e.e.e.e.e.e.e.e.e.e.e.e.e.e.e.e.e.e.e.e.e...",
        "...e.e.@.e.e.e.e.e.e.e.e.e.e.@.@.@.@.@.@.e.e.@.@.@.@.@.e.@.@.e.e.@.@.@.e.@.e.@.@.e.e.@.@...",
        "w..e.e.e.@.@.e.e.e.e.@.@.e.e.e.e.e.e.e.e.e.e.e.e.e.e.e.@.e.e.@.@.e.e.e.@.e.@.e.e.@.@.e.e..w",
        "...@.@.e.e.e.@.@.@.@.e.e.@.@.e.e.e.e.e.e.@.@.e.e.e.e.e.e.e.e.e.e.e.e.e.e.e.e.e.e.e.e.e.e...",
        "...e.e.@.e@e.e.e.e.e.e.e.e.e.@.@.@.@.@.@.e.e.@.@.@.@.@.e.@.@.e.e.@.@.@.e.@.e.@.@.e.e.@.@...",
        "w..e.e.e.e.e.e.e.e.e.@.@.e.e.e.e.e.e.e.e.e.e.e.e.e.e.e.@.e.e.@.@.e.e.e.@.e.@.e.e.@.@.e.e..w",
        "...@.@.e.@.@.@.@.@.@.e.e.@.@.e.e.e.e.e.e.@.@.e.e.e.e.e.e.e.e.e.e.e.e.e.e.e.e.e.e.e.e.e.e...",
        "...e.e.@.e.e.e.e.e.e.e.e.e.e.@.@.@.@.@.@.e.e.@.@.@.@.@.e.@.@.e.e.@.@.@.e.@.e.@.@.e.e.@.@...",
        "w..e.e.e.e.e.e.e.e.e.@.@.e.e.e.e.e.e.e.e.e.e.e.e.e.e.e.@.e.e.@.@.e.e.e.@.e.@.e.e.@.@.e.e..w",
        "...@.@.e.@.@.@.@.@.@.e.e.@.@.e.e.e.e.e.e.@.@.e.e.e.e.e.e.e.e.e.e.e.e@e.e.e.e.e.e.e.e.e.e...",
        "...e.e.@.e.e.e.e.e.e.e.e.e.e.@.@.@.@.@.@.e.e.@.@.@.@.@.e.@.@.e.e.@.e.e.@.@.e.@.@.e.e.@.@...",
        "w..e.e.e.e.e.e.e.e.e.@.@.e.e.e.e.e.e.e.e.e.e.e.e.e.e.e.@.e.e.@.@.e.@.@.e.e.@.e.e.@.@.e.e..w",
        "...@.@.e.@.@.@.@.@.@.e.e.@.@.e.e.e.e.e.e.@.@.e.e.e.e.e.e.e.e.e.e.e.e.e.e.e.e.e.e.e.e.e.e...",
        "...e.e.@.e.e.e.e.e.e.e.e.e.e.@.@.@.@.@.@.e.e.@.@.@.@.@.e.@.@.e.e.@.e.e.@.@.e.@.@.e.e.@.@...",
        "w..e@e.e.e.e.e.e.e.e.@.@.e.e.e.e.e.e.e.e.e.e.e.e.e.e.e.@.e.e.@.@.e.@.@.e.e.@.e.e.@.@.e.e..w",
        "...e.e.e.@.@.@.@.@.@.e.e.@.@.e.e.e.e.e.e.@.@.e.e.e.e.e.e.e.e.e.e.e.e.e.e.e.e.e.e.e.e.e.e...",
        "...@.@.@.e.e.e.e.e.e.e.e.e.e.@.@.@.@.@.@.e.e.@.@.@.@.@.e.@.@.@.e.@.e.e.@.@.e.@.@.e.e.@.@...",
        "w..e.e.e.e.e.e.e.e.e.@.@.e.e.e.e.e.e.e.e.e.e.e.e.e.e.e.@.e.e.e.@.e.@.@.e.e.@.e.e.@.@.e.e..w",
        "...e.e.e.@.@.@.@.@.@.e.e.@.@.e.e.e.e.e.e.@.@.e.e.e.e.e.e.e.e.e.e.e.e.e.e.e.e.e.e.e.e.e.e...",
        "...@.@.@.e.e.e.e.e.e.e.e.e.e.@.@.@.@.@.@.e.e.@.@.@.@.@.e.@.@.@.e.@.e.e.@.@.e.@.@.e.e.@.@...",
        "w..e.e.e.e.e.e.e.e.e.@.@.e.e.e.e.e.e.e.e.e.e.e.e.e.e.e.@.e.e.e.@.e.@.@.e.e.@.e.e.@.@.e.e..w",
        "...e.e.e.@.@.@.@.@.@.e.e.@.@.e.e.e.e.e.e.@.@.e.e.e.e.e.e.e.e.e.e.e.e.e.e@e.e.e.e.e.e.e.e...",
        "...@.@.@.e.e.e.e.e.e.e.e.e.e.@.@.@.@.@.@.e.e.@.@.@.@.@.e.@.@.@.e.@.e.e.e.e.e.@.@.e.e.@.@...",
        "w..e.e.e.e.e.e.e.e.e.@.@.e.e.e.e.e.e.e.e.e.e.e.e.e.e.e.@.e.e.e.@.e.@.@.@.@.@.e.e.@.@.e.e..w",
        "...e.e.e.@.@.@.@.@.@.e.e.@.@.e.e.e.e.e.e.@.@.e.e.e.e.e.e.e.e.e.e.e.e.e.e.e.e.e.e.e.e.e.e...",
        "...@.@.@.e.e.e.e.e.e.e@e.e.e.@.@.@.@.@.@.e.e.@.@.@.@.@.@.@.@.@.e.@.e.e.e.e.e.@.@.e.e.@.@...",
        "w..e.e.e.e.e.e.e.e.e.e.e.e.e.e.e.e.e.e.e.e.e.e.e.e.e.e.e.e.e.e.@.e.@.@.@.@.@.e.e.@.@.e.e..w",
        "...e.e.e.@.@.@.@.@.@.@.@.@.@.e.e.e.e.e.e.@.@.e.e.e.e.e.e.e.e.e.e.e.e.e.e.e.e.e.e.e.e.e.e...",
        "...@.@.@.e.e.e.e.e.e.e.e.e.e.@.@.@.@.@.@.e.e.@.@.@.@.@.@.@.@.@.e.@.e.e.e.e.e.@.@.e.e.@.@...",
        "w..e.e.e.e.e.e.e.e.e.e.e.e.e.e.e.e.e.e.e.e@e.e.e.e.e.e.e.e.e.e.@.e.@.@.@.@.@.e.e.@.@.e.e..w",
        "...e.e.e.@.@.@.@.@.@.@.@.@.@.e.e.e.e.e.e.e.e.e.e.e.e.e.e.e.e.e.e.e.e.e.e.e.e.e@e.e.e.e.e...",
        "...@.@.@.e.e.e.e.e.e.e.e.e.e.@.@.@.@.@.@.@.@.@.@.@.@.@.@.@.@.@.@.@.e.e.e.e.e.e.e.e.e.@.@...",
        "w..e.e.e.e.e.e.e.e.e.e.e.e.e.e.e.e.e.e.e.e.e.e.e.e.e.e.e.e.e.e.e.e.@.@.@.@.@.@.@.@.@.e.e..w",
        "...e.e.e.@.@.@.@.@.@.@.@.@.@.e.e.e.e.e.e.e.e.e.e.e.e.e.e.e.e.e.e.e.e.e.e.e.e.e.e.e.e.e.e...",
        "...@.@.@.e.e.e.e.e.e.e.e.e.e.@.@.@.@.@.@.@.@.@.@.@.@.@.@.@.@.@.@.@.e.e.e.e.e.e.e.e.e.@.@...",
        "w..e.e.e.e.e.e.e.e.e.e.e.e.e.e.e.e.e.e.e.e.e.e.e.e.e.e.e.e.e.e.e.e.@.@.@.@.@.@.@.@.@.e.e..w",
        "...e.e.e.@.@.@.@.@.@.@.@.@.@.e.e.e.e.e.e.e.e.e.e.e.e.e.e.e.e.e.e.e.e.e.e.e.e.e.e.e.e.e@e...",
        "...@.@.@.e.e.e.e.e.e.e.e.e.e.@.@.@.@.@.@.@.@.@.@.@.@.@.@.@.@.@.@.@.........................",
        "w..e.e.e.e.e.e.e.e.e.e.e.e@e.e.e.e.e.e.e.e.e.e.e.e.e.e.e.e.e.e.e.e.@@@@@@@@@@@@@@@@@@@@@@.w",
        "...@.e.e.@.@.@.@.@.@.@.@.e.........................................eeeeeeeeeeeeeeeeeeeeee..",
        "...e.@.@.e.e.e.e.e.e.e.e.@@@@@e@@@@@@@@@@@e@@@@@e@@e@@e@e@@e@@@@@@@@@@@@@@@@@@@@@@@@@@@@@..",
        "w..e.e.e.e................eee...eeeeeeeee...eee..............eeeeee.......................w",
        "...@.e.e.@.@@@@@@@@@@@@@@@@@@@@@@@@@@@@@@@@@@@@@@@@@@@@@@@@@@@@@@@@@@@@@@@@@@@@@@@@@@@@@@..",
        "...e.@.@.e.eeeeeeeeeeeeeee...eee.........eee...eeeeeeeeeeeeee......eeeeeeeeeeeeeeeeeeeeee..",
        "w.@e.e.e.e@@@@@@@@@@@@@@@@@e@@@@@e@@e@@e@@@@@e@@@@@@@@@@@@@@@@e@@e@@@@@@@@@@@@@@@@@@@@@@@.w",
        "..........................................................................................."
    ],
    "nca_runtime": 0.1789391040802002,
    "milp_runtime": 5608.9300038814545,
    "nca_milp_runtime": 5609.108942985535,
    "sim_score": null,
    "weight": false,
    "n_row": 93,
    "n_col": 91,
    "n_endpoint": 2436,
    "n_agent_loc": 0,
    "n_shelf": 1840,
    "maxtime": 5000
}
