{
    "name": "kiva_57x58_cma-mae_opt_entropy_throughput_hamming_a=0",
    "layout": [
        "..e@e@@e@ee@e@@e@@e@@e@@e@@e@@e@@e@@e@@e@@e@@e@@e@@e@@e@..",
        "w.e......................................................w",
        "..@e@@ee@@e.e@.@e@@e@@e@e@@e@@e@@e@e@@e@.@e@@e@@e@@e@@e@..",
        "..e.......................................................",
        "w.e.e.e..@...@.@e@.@e...@@e@@@e@@@e@@@e@@.@.@@e.......@e.w",
        "..@.@.@..e...e.....e....e.e.e.e.e.e.e.e.e.e.e.e...........",
        "..e.e.e.e@........@.@e..@.@.@.@.@.@.@.@.@.@.@.@.......@e..",
        "w.e.e.e.@...e.....e.@e....e...e.e.e.e.e.e................w",
        "..@.@.@.e.@.@......e@.@.@.e.e@........@.@e@e@e@@e@@e@@e@..",
        "..e.e.e.e.e...........e.e@@..e............................",
        "w.e.@.@.@.@.@.@.@.@ee@e.e.e.@.@.@.@.@......e@@e@@e@e@@e@.w",
        "..@.e.e.e.e.e.e.e.e.e.e.@.e.e.e.e.e.e.....@.e.............",
        "..e.@.@.@.@.@.@.@.@.@.@.@.@.@.@.@.@.....@@e.@e@e@e@@e@@e..",
        "w...e.e.e.e.e.e.e.e.e.e.e.e.e.e.e.e.e.e.e.e.e............w",
        "..e.@.@.@.@.@.@.@.@.@.@.@.@.@.@.@.@.@.@.@.@...@e@.@.@.@...",
        "..@.e.e.e.e.e.e.e.e.e.e.e.e.e.e.e.e.e.e.e.e.......e.e.e...",
        "w.e.e.e.e.e.e.e.e.e.e.e.e.e.e.e.e.e.e.e.e.e.e.e.e.e.e.e..w",
        "..e.@.@.@.@.@.@.@.@.@.@.@.@.@.@.@.@.@.@.@.@.@.@.@.@.@.@...",
        "..@.e.e.e.e.e.e.e.e.e.e.e.e.e.e.e.e.e.e.e.e.e.e.e.e.e.e...",
        "w.e.@.@.@.@.@...@.@.@.@.@.@.@.@.@.@.@.@.@.@.@.@.@.@.@.@..w",
        "..e.e.e.e.e.e.e.e.e.e.e.e.e.e............@.e.......ee.e...",
        "..@.@.@.@.@.@.@.@.@.@.@.@.@.@.@.@.@.@.@e.e.@.@e@@e@@..@e..",
        "w.e.e.e.e.e.e.e.e.e.e.e.e.e.e.e.e.e.e.................e..w",
        "..e.e.e.e.e.e.e.e.e.e.e.e.e.e.e.e.e.e.e.e.e.e.@.@.@.@.@...",
        "..@.@.@.@.@.@.@.@.@.@.@.@.@.@.@.@.@.@.@.@.@.@.e.e.e.e.e...",
        "w.e.e.e.e.e.e.e.e.e.e.e.e.e.e.e.e.e.e.e.e.e.e.e.e.e.@.@..w",
        "..e.@...@.@.@.@.@.@.@.@.@.@.@.@.@.@.@.@.@.@.@.@.@.@.@.e...",
        "..@.e.e.e.e.e.e.e.e.e.e.e.e.e.e.e.e.e.e.e.e.e.e.e.e.e.e...",
        "w.e.@.@.@...@.@.@.@.@.@.@.@.@.@.@.@.@.@.@.@.@.@.@.@.@.@..w",
        "..e.e.e.e.e.e.e.e.e.e.e.e.e.e.e.e.e.e.e.e.e.e.e.e.e.e.e...",
        "..@.@.@...@.@.@.@.@.@.@.@.@.@.@.@.@.@.@.@.@.@.@.@.@.@.....",
        "w.e.e.e.e.e.e.e.e.e.e.e.e.e.e.e.e.e.e.e.e.e.e.e.e.e.e.e..w",
        "....@.@.@.@.@.@.@.@.@.@.@.@.@.@.@.@.@.@.@.@.@.@.@.@.@.@...",
        "..e.e.e.e.e.e.e.e.e.e.e.e.e.e.e.e.e.e.e.e.e.e.e.e.e.e.e...",
        "w.@.@.@.@.@.@.@.@...@.@.@.@.@.@.@.@.@.@.@.@.@.@.@.@.@.@..w",
        "..e.e.e.e.e.e.e.e.e.e.e.e.e.e.e.e.e.e.e.e.e.e.e.e.e.e.e...",
        "..e.@.@.@.@.@.@.@.@...@...@.@.@.@.@.@.@.@.@.@.@.@.@.@.@...",
        "w.@.e.e.e.e.e.e.e.e.e.e.e.e.e.e.e.e.e.e.e.e.e.e.e.e.e.e..w",
        "..e.@.@.@.@.@.@.@.@.@...@.@.@.@...@.@.@.@.@.@.@.@.@.@.@...",
        "..e.e.e.e.e.e.e.e.e.e.e.e.e.e.e.e.e.e.e.e.e.e.e.e.e.e.e...",
        "w.@.@.@.@.@.@.@.@.@.@.@.@.@.@.@.@.@.@.@.@.@.@.@.@.@.@.@..w",
        "..e.e.e.e.e.e.e.e.e.e.e.e.e.e.e.e.e.e.e.e.e.e.e.e.e.e.e...",
        "..e.@.@.@.@.@.@.@.@.@.@.@.@.@.@.@.@.@.@.@.@.@.@.@.@.@.@...",
        "w.@.e.e.e.e.e.e.e.e.e.e.e.e.e.e.e.e.e.e.e.e.e.e.e.e.e.e..w",
        "..e.@.@.@...@.@...@.@.@.@.@.@.@.@.@.@.@.@.@.@.@.@.@.@.....",
        "..e.e.e.e.e.e.e.e.e.e.e.e.e.e.e.e.e.e.e.e.e.e.e.e.e.e.e...",
        "w.@.@.@.@.@.@.@.@.@.@.@.@.@.@.@.@.@.@.@.@.@.@...@...@.@..w",
        "..e.e.e.e.e.e.e.e.e.e.e.e.e.e.e.e.e.e.e.e.e.e.e.e.e.e.e...",
        "...e................@e....@e@.@.@.@.@.@.@.@.@.@.@.@.@.@...",
        "w..@.@.@.@.@.@.@.@.@.@.@.@.@.e@ee.e.e.e.e.e.e.e.e.e.e.e..w",
        "...e.e.e.e.e.e.e.e.e.e.e.e.@......@...@...@.......@...@e..",
        "...e.e.e.e.e.e.e.e.e.e.e.e.e...@.@.@.@.@.@.@.@.@.@.@......",
        "w..@.@.@.@.@.@.@.@.@.@.@.@...e.e.e.e.e.e.e.e.e.e.e.e.e.e.w",
        "...e.e.e.e.e.e.e.e.e.e.e.e.@.@.@.@.@.@.@.@.@.@.@.@.@.@.@..",
        "...........................e.e.e.e.e.e.e.e.e.e.e.e.e.e....",
        "w........................................................w",
        "..e@@e@@e@@e@@e@@e@e@@ee@@e@e@@e@@e@@e.e@@e@@e@@e@@e@@e@.."
    ],
    "nca_runtime": 0.11168766021728516,
    "milp_runtime": 5.3184521198272705,
    "nca_milp_runtime": 5.430139780044556,
    "sim_score": null,
    "weight": false,
    "n_row": 57,
    "n_col": 58,
    "n_endpoint": 738,
    "n_agent_loc": 0,
    "n_shelf": 700,
    "maxtime": 5000
}