{
    "name": "kiva_45x47_cma-mae_opt_entropy_uneven_throughput_hamming_a=5",
    "layout": [
        "...e.......................................e...",
        "w..@.@.@.@.@.@.@.@.@.@.@.@.@.@.@.@.@.@.@.@.@e.w",
        "...e.e.e.e.e.e.e.e.e.e.e.e.e.e.e.e.e.e.e.e.e...",
        "...e.e.e.e.e.e.e.e.e.e.e.e.e.e.e.@.e.@.e.e.e...",
        "w..@.@.@.@.@.@.@.@.@.@.@.@.@.@.@.e.@.e.@.@.@..w",
        "...e.e.e.e.e.e.e.e.e.e.e.e.e.e.e.e.e.e.e.e.e...",
        "...e.e.e.e.e.e.e.e.e.e.e.e.e.e.e.@.e.@.e.e.e...",
        "w..@.@.@.@.@.@.@.@.@.@.@.@.@.@.@.e.@.e.@.@.@..w",
        "...e.e.e.e.e.e.e.e.e.e.e.e.e.e.e.e.e.e.e.e.e...",
        "...e.e.e.e.e.e.e.e.e.e.e.e.e.e.@.@.e.@.@.e.@...",
        "w..@.@.@.@.@.@.@.@.@.@.@.@.@.@.e.e.@.e.e.@.e..w",
        "...e.e.e.e.e.e.e.e.e.e.e.e.e.e.e.e.e.e.e.e.e...",
        "...e.e.e.e.e.e.e.e.@.e.e.e.e@e.@.@.e.@.@.e.@...",
        "w..@.@.@.@.@.@.@.@.e.@.@.@.e.e.e.e.@.e.e.@.e..w",
        "...e.e.e.e.e.e.e.e.e.e.e.e.@.@.e.e.e.e.e.e.e...",
        "...e.e.e.e.e.e.e.e.@.e@e.@.e.e.@.@.e.@.@.e.@...",
        "w..@.@.@.@.@.@.@.@.e.e.e.e.e@e.e.e.@.e.e.@.e..w",
        "...e.e.e.e.e.e.e.e.e.@.@.e.e.e.e.e.e.e.e.e.e...",
        "...e.e.e.e.e.e.e.@.@.e.e.@.@.@.@.@.e.@.@.@.@...",
        "w..@.@.@.@.@.@.@.e.e.e@e.e.e.e.e.e.@.e.e.e.e..w",
        "...e.e.e.e.e.e.e...............................",
        "...e@e.e.e.e.e.e@e@@e@@e..@e@.e@@e@@e@e@e@@e@..",
        "w..e.e.@.@.@.@................................w",
        "...@.@.e.e.e.e.@e@@e@@e@@e@@e@@e@@e@@e@@e@@e@..",
        "...e.e.e.@.e...................................",
        "w..e.e.@.e.@.@e@e@@e@@e@@e@..@e@@e@@e@.@e@@e@.w",
        "...@.@.e.......................................",
        "...e.e.e@e@@e@@e@@e@@e@@e@e@.@e@@e@@e@@e@@ee@..",
        "w.e...........................................w",
        "..@e@@e@@e@@e@@ee@@e@@e@@e@@e@@e@.@e@@e@@e@e@..",
        "..e............................................",
        "w.e@e@e@@e@e@@e@@e@e@@e@@e@@e@@e@@e@e@@e@@ee@.w",
        "...............................................",
        "..@e@@ee@@e@@e@@e@@e@@e@.@e@e@@e@@e@@e@@e@@e@..",
        "w.............................................w",
        "..e@@e@@e@@e@@e@@e@@e@@e@@e@@e@@e@@e@@e@@e@e@..",
        "...............................................",
        "w.e@.@e@@e@@e@@e..@e@.e@@ee@.@e@@ee@@e@@e@@e@.w",
        "...............................................",
        "..e@e@@ee@@e@e@@e@@ee@e@e@@e@@e@.@e@@e@@e@@e@..",
        "w.............................................w",
        "..e@@e@@e.@e@@e@@e@ee@@e@@e@@e@@e@..@e@@e@@e@..",
        "...............................................",
        "w.@ee@@e@@ee@@ee@.@e@@e..@e@.@e@.@e@e@@ee@@e@.w",
        "..............................................."
    ],
    "nca_runtime": 0.09714245796203613,
    "milp_runtime": 4.081906318664551,
    "nca_milp_runtime": 4.179048776626587,
    "sim_score": null,
    "weight": false,
    "n_row": 45,
    "n_col": 47,
    "n_endpoint": 460,
    "n_agent_loc": 0,
    "n_shelf": 440,
    "maxtime": 5000
}