{
    "name": "kiva_45x47_cma-mae_opt_entropy_uneven_throughput_hamming_a=0",
    "layout": [
        "...e.e.e.@e@@e@@e@@e@e@@e@@e@@e@@e@@e@@e@@e@...",
        "w..@.@.@......................................w",
        "...e.e.e....................................e..",
        "...e.e.e.@e@@e@@e@@e@@e@@e@@e@e@@e@@e@@e@@e@@..",
        "w..@.@.@......................................w",
        "...e.e.e.e@@................................e..",
        "...e.e.e.@.e.@e@@e@@e@@e@.@e@@e@@e@@e@@e@@e@@..",
        "w..@.@.@.e.e..................................w",
        "...e.e.e.e.@.e@@............................e..",
        "...e.e.e.@.e.e.e.@e@@ee@@e@@e@@e@@e@e@@e@@e@@..",
        "w..@.@.@.e.e.@.e..............................w",
        "...e.e.e.e.@.e.@.e@@........................e..",
        "...e.e...@.e.e.e.e.e.e@@e@@e@@e@@e@@e@@e@@e@@..",
        "w..@.@.e.e.e.@.e.@.e..........................w",
        "...e.e.@.e.@.e.@.e.@.e@@....................e..",
        "...e.e.e.@.e...e.e.e.e.e.@@e.@e@@e@@e@@e@@e@@..",
        "w..@.@.e.e.e.e.e.@.e.@.e.e....................w",
        "...e.e.@.e.@.@.@.e.@.e.@....................e..",
        "...e.e.e.@.e.e.e.e.e.@.e.e@@e@@e@@e@@e@@e@@e@..",
        "w..@.@.e.e.e.e.e.@.e.e.e......................w",
        "...e.e.@.e.@.@.@.e.@.e.@.@e@@e@@e@e@@e@@e@@e@..",
        "...e.e.e.@.e.e.e.e.e.@.e.......................",
        "w..@.@.e.e.@.e.e.@.e.e.@......................w",
        "...e.e.@.e.e.@.@.e.@.e.e.@e@@e@@e@@e@e@@e@@e@..",
        "...e.e.e.@.e.e.e.e.e.@.........................",
        "w..@.@.e.e.@.e...@.e.e.@ee@@e@@e@@e@@e@@e@@e@.w",
        "...e.e.@.e.e.@.e.e.@...........................",
        "...e.e.e.@.e.e.@.e.e.@e@@e@@e@@e@@e@@e@@e@@e@..",
        "w..@.@.e.e.@.e.e.@............................w",
        "...e.e.@.e.e.@.e.e.@e@@e@@ee@@e@e@@e@@e@@e@@e..",
        "...e.e.e.@.e.e.@...............................",
        "w..@.@.e.e.@.e.e.@e@e@@e@@e@@e@@e@@e@@e@@e@e@.w",
        "...e.e.@.e.e.@.................................",
        "...e.e.e.@.e.e.@e@@e@@e@@e@e@@e@@e@.@e@@e@@e@..",
        "w..@.@.e.e.@..................................w",
        "...e.e.@.e.e.@e@e@@e@.@e@ee@@e@@e@@e@@e@@e@....",
        "...e.e.e.@.....................................",
        "w..@.@.e.e.e@@e@@e@@e@@e@@e@@e@@e@@e@e@e@@ee@.w",
        "...e.e.@.......................................",
        "...@.e.e..e@@e@@e@@e@e@@e@@e@@e@@e.@e@ee@.@e@..",
        "w..e.@........................................w",
        "...e.e..e@@e@@e@@e@@e..e@@e.e@@e@@e@@e....@e@..",
        "...@...........................................",
        "w..e.e@@ee@@e@@e@e@@e@.@e@@e.e@@e@@e@@e@.@ee@.w",
        "..............................................."
    ],
    "nca_runtime": 0.1014566421508789,
    "milp_runtime": 3.9444406032562256,
    "nca_milp_runtime": 4.0458972454071045,
    "sim_score": null,
    "weight": false,
    "n_row": 45,
    "n_col": 47,
    "n_endpoint": 391,
    "n_agent_loc": 0,
    "n_shelf": 440,
    "maxtime": 5000
}