{
    "name": "kiva_93x91_cma-mae_opt_entropy_throughput_hamming_a=5",
    "layout": [
        "...........................................................................................",
        "w.e@@ee@@ee@@ee@@ee@@ee@@e.e@ee@@ee@@ee@@ee@@ee@e.e@@ee@@ee@@ee@@ee@@ee@@ee@@ee@@ee@@e.e@.w",
        "...........................................................................................",
        "..e@@ee@@ee@@ee@@ee@@e.e@ee@@ee@@ee@@ee@@ee@..e@@ee@@ee@@ee@@ee@@ee@@ee@@ee@@ee@@ee@ee@e...",
        "w.........................................................................................w",
        "..e@@ee@@ee@@ee@@ee@@ee@@ee@@e.e@ee@@ee@@ee@..e@..e@@ee@@ee@@ee@@ee@@ee@@ee@@ee@@ee@@e.e@..",
        "...........................................................................................",
        "w.e@@ee@@ee@@ee@@ee@@ee@@ee@@ee@@ee@@ee@@ee@@ee@@ee@@ee@@ee@@ee@@ee@@ee@@ee@@ee@@ee@@ee@e.w",
        "...........................................................................................",
        "..e@@ee@@ee@@ee@@ee@@ee@@ee@@ee@@ee@@ee@@ee@@e..@ee@@ee@@ee@@ee@@ee@@ee@@e.e@ee@@ee@@ee@e..",
        "w.........................................................................................w",
        "....@ee@@ee@@ee@@ee@@ee@@ee@@ee@@ee@@ee@@ee@@ee@@ee@@ee@@ee@@ee@@ee@@ee@@ee@@ee@@e..@e.e@..",
        "...........................................................................................",
        "w.e@@ee@..e@@e.e@ee@@ee@@ee@@e..@ee@@ee@@ee@@ee@@ee@@ee@@ee@@ee@@ee@@ee@@ee@@ee@@ee@@ee@e.w",
        "...........................................................................................",
        "..e@@ee@@ee@@ee@..e@..e@@ee@@ee@@e.e@ee@@ee@@ee@@ee@@ee@@ee@@ee@@ee@@ee@@ee@@ee@@e...e@e...",
        "w.........................................................................................w",
        "..e@@ee@@ee@@ee@@ee@@ee@@ee@@ee@@ee@@ee@@ee@@ee@@ee@e.e@@ee@@ee@@ee@@ee@@ee@@ee@@ee@@e.e@..",
        "...........................................................................................",
        "w.e@@ee@@e..@ee@@ee@@ee@..e@@ee@@ee@@ee@..e@@ee@@ee@@ee@@ee@@ee@@e..@ee@@ee@@ee@@ee@@ee@e.w",
        "...........................................................................................",
        "..e@@ee@@ee@@ee@..e@@ee@@ee@@ee@@e.e@ee@@ee@..e@@e.e@ee@@ee@@ee@@ee@..e@@ee@@ee@@ee@@ee@e..",
        "w.........................................................................................w",
        "..e@@ee@@ee@@ee@@ee@@ee@@ee@@ee@@ee@..e@@ee@@e..@e.e@ee@@ee@@ee@@ee@@ee@@ee@@e..@ee@@e.e@..",
        "...........................................................................................",
        "w.e@@ee@@ee@@ee@@ee@@e.e@ee@@ee@@ee@@ee@@ee@@ee@@ee@@ee@@ee@@ee@@e..@ee@@ee@@ee@@ee@@ee@e.w",
        "...........................................................................................",
        "..e@@ee@@ee@@e..@ee@@ee@@ee@@ee@@ee@@ee@@ee@e.e@@ee@@ee@@ee@@ee@@ee@@ee@@ee@@ee@@e.e@ee@e..",
        "w.........................................................................................w",
        "..e@@ee@@ee@..e@@ee@@ee@@ee@@ee@@ee@@ee@@e..@ee@@ee@@ee@@ee@@ee@@ee@@ee@@ee@@ee@@ee@@e.e@..",
        "...........................................................................................",
        "w.e@@ee@@e..@ee@@ee@@e.e@ee@@ee@@ee@@ee@@ee@@ee@@ee@@ee@@ee@@e.e@ee@@ee@@ee@@ee@@ee@@ee@e.w",
        "...........................................................................................",
        "..e@@e..@ee@@ee@..e@@ee@@ee@@e..@ee@@ee@@ee@@ee@@ee@@ee@@ee@@ee@@ee@@ee@e.e@@ee@@ee@ee@e...",
        "w.........................................................................................w",
        "..e@@ee@@ee@@ee@@ee@@ee@@ee@@ee@@ee@..e@@ee@@ee@@ee@@ee@@ee@@ee@@ee@..e@...e@ee@@ee@@e.....",
        "...........................................................................................",
        "w.e@@ee@@e..@ee@@ee@@ee@@ee@@ee@@ee@@ee@@ee@@ee@..e@@ee@@ee@@e.e@ee@@ee@@ee@@e.e@ee@@ee@e.w",
        "...........................................................................................",
        "..e@@ee@@ee@@ee@@e..@ee@@ee@@ee@@ee@@e.e@ee@@ee@@ee@@ee@@ee@@ee@@ee@@ee@@ee@@ee@..e@@ee@e..",
        "w.........................................................................................w",
        "..e@@ee@@ee@@ee@@ee@@ee@@ee@@ee@@ee@@ee@@ee@@ee@@ee@@e.e@ee@@ee@..e@@ee@@ee@@ee@@ee@@e.e@..",
        "...........................................................................................",
        "w.e@@ee@@ee@@ee@@ee@@ee@@ee@@ee@@ee@@ee@@ee@@ee@@ee@@ee@@ee@@ee@@ee@@ee@@ee@@ee@@ee@..e@e.w",
        "...........................................................................................",
        "..e@@e.e@ee@@ee@@ee@@ee@@e..@e..@ee@@ee@@ee@e.e@@ee@@ee@@ee@@ee@@ee@@ee@@ee@@ee@@ee@@ee@e..",
        "w.........................................................................................w",
        "..e@@ee@@ee@@ee@@e.e@ee@@ee@@ee@@ee@@ee@..e@@ee@@ee@@e.e@ee@@ee@@ee@@ee@@ee@@ee@@ee@@e.e@..",
        "...........................................................................................",
        "w.e@@ee@@ee@@ee@@ee@@ee@..e@@ee@@ee@@ee@@e..@ee@@ee@..e@@ee@@ee@@ee@@e.e@ee@@ee@@ee@..e@e.w",
        "...........................................................................................",
        "..e@@ee@@ee@@ee@@ee@@ee@@ee@@ee@..e@@ee@@ee@@ee@@ee@@ee@@ee@@ee@@ee@@ee@@ee@@ee@@ee@@ee@e..",
        "w.........................................................................................w",
        "..e@@ee@@ee@@ee@@ee@..e@@e..@ee@@ee@@ee@@ee@@ee@@ee@@ee@@ee@@ee@@ee@@ee@@ee@@ee@@ee@@e.e@..",
        "...........................................................................................",
        "w.e@@ee@@ee@@ee@@ee@..e@@ee@@ee@@ee@@ee@@ee@@ee@@ee@..e@@ee@@ee@@ee@@ee@..e@@ee@@ee@@ee@e.w",
        "...........................................................................................",
        "...e@ee@@ee@@ee@@ee@@ee@@ee@@ee@@ee@@ee@@ee@@ee@@ee@..e@@ee@@ee@@ee@@ee@@ee@e.e@@ee@@ee@e..",
        "w.........................................................................................w",
        "...e@ee@@ee@@ee@@ee@@ee@@ee@@ee@@ee@@ee@e.e@@ee@@ee@@e..@ee@..e@@ee@@ee@@ee@@e.e@ee@@e.e@..",
        "...........................................................................................",
        "w..e@ee@@ee@@ee@@e..@ee@@ee@@ee@@ee@@ee@@ee@@ee@@ee@..e@@ee@@ee@@ee@@e.e@ee@@ee@@ee@@ee@e.w",
        "...........................................................................................",
        "..e@@ee@@ee@@ee@@ee@..e@@ee@@ee@@ee@@ee@@ee@@ee@@ee@@ee@@ee@@ee@@ee@@ee@@ee@@ee@@e.e@ee@e..",
        "w.........................................................................................w",
        "..e@@ee@e.e@@ee@@ee@@ee@@ee@@e..@ee@@ee@@ee@@ee@@ee@@ee@@ee@@ee@@e..@ee@@ee@@ee@@ee@@e.e@..",
        "...........................................................................................",
        "w.e@@ee@@e.e@ee@@ee@..e@..e@@ee@@ee@@ee@@ee@@ee@@ee@@ee@@ee@@e..@ee@@ee@@ee@@ee@@ee@@ee@e.w",
        "...........................................................................................",
        "..e@@ee@@ee@@ee@@ee@@ee@@ee@@ee@@ee@@ee@@ee@@ee@@ee@@ee@@ee@@e..@ee@@ee@@ee@@ee@@ee@@ee@e..",
        "w.........................................................................................w",
        "..e@@ee@@ee@@ee@@ee@@ee@@ee@@ee@@ee@@ee@@ee@@ee@..e@@ee@@ee@@ee@..e@@ee@@ee@@ee@@ee@@e.e@..",
        "...........................................................................................",
        "w.e@@e.e@ee@@ee@@ee@@ee@@ee@@ee@@ee@@ee@@ee@@ee@@ee@@ee@@ee@@ee@..e@..e@@ee@@ee@@ee@@e....w",
        "...........................................................................................",
        "..e@@ee@@ee@@ee@@ee@@e.e@ee@@ee@@ee@@ee@@ee@@ee@@ee@@ee@@ee@@ee@@ee@@ee@@ee@@ee@@ee@@ee@e..",
        "w.........................................................................................w",
        "..e@@ee@@ee@@ee@@ee@..e@@ee@@ee@@ee@..e@@ee@@e.e@ee@@ee@@ee@@ee@@ee@@e.e@ee@@ee@@ee@@e.e@..",
        "...........................................................................................",
        "w.e@@ee@@ee@@ee@@ee@@ee@@ee@@ee@@ee@@ee@@ee@..e@@ee@@ee@@ee@@e..@ee@@e..@ee@@e.e@ee@@ee@e.w",
        "...........................................................................................",
        "..e@@ee@@ee@@ee@@ee@@ee@..e@@ee@@ee@@ee@@ee@@ee@@ee@@ee@@ee@@ee@@ee@@ee@..e@@ee@@ee@@ee@e..",
        "w.........................................................................................w",
        "...e@e....e@@ee@@ee@@ee@@ee@@ee@@ee@@ee@@ee@@ee@@ee@@ee@@e.e@ee@@ee@@ee@..e@@ee@@ee@@e.e@..",
        "...........................................................................................",
        "w...@ee@@ee@@ee@@ee@@ee@..e@@ee@@ee@@ee@@ee@@ee@@ee@e.e@@ee@@ee@@ee@@ee@@ee@@ee@..e@@ee@e.w",
        "...........................................................................................",
        "..e@@ee@@ee@@ee@@ee@@ee@@ee@@ee@@ee@@ee@@ee@@ee@@ee@@ee@@ee@@ee@@ee@@ee@@ee@@ee@..e@..e@e..",
        "w.........................................................................................w",
        "..e@@ee@@ee@@ee@@ee@@ee@..e@@ee@@ee@@ee@..e@@ee@@ee@@ee@@ee@@ee@@ee@@ee@@ee@@ee@@ee@@ee@e..",
        "...........................................................................................",
        "w.e@@ee@@ee@@ee@@ee@@ee@@ee@@ee@@e......@ee@@ee@@ee@@ee@@ee@@ee@@ee@@ee@e.e@@ee@@ee@@ee@e.w",
        "..........................................................................................."
    ],
    "nca_runtime": 0.735313892364502,
    "milp_runtime": 29.678230047225952,
    "nca_milp_runtime": 30.413543939590454,
    "sim_score": null,
    "weight": false,
    "n_row": 93,
    "n_col": 91,
    "n_endpoint": 1918,
    "n_agent_loc": 0,
    "n_shelf": 1840,
    "maxtime": 5000
}