{
    "name": "kiva_57x58_cma-mae_opt_entropy_uneven_throughput_hamming_a=5",
    "layout": [
        "...e......................................................",
        "w..@.@.@.@.@.@.@.@.@.@.@.@.@.@ee@.@.@.@.@.@.@.@.@.@.@@e@.w",
        "...e.e.e.e.e.e.e.e.e.e.e.e.e.e....e.e.e.e.e.e.e.e.e.e..e..",
        "...e.@.e...e.e.e.e.e.e.e.e.e.e............................",
        "w..@.e.@.e.@.@.@.@.@.@.@.@.@.@.e@.e@@e@@e@@e@@e@@e@@e@@e.w",
        "...e.e.e.@.e.e.e.e.e.e.e.e.e.e.e..........................",
        "...e.@.e.e.e.e.e.e.e.e.e.e.e.e.@..e@@e@e@@e@.@e@@e@@e@@e..",
        "w..@.e.@.e.@.@.@.@.@.@.@.@.@.@.e.........................w",
        "...e.e.e.@.e.e.e.e.e.e.e.e.e.e.e.@@e@.e@@e@@e@@e@@e@@e@e..",
        "...e.@.e.e.e.e.e.@.e@e.e.e.e.e.@.e........................",
        "w..@.e.@.e.@.@.@.e.e.e.@.@.@.@.e.@.@e@@e@e@@e@e@@e@@e@e@.w",
        "...e.e.e.@.e.e.e.e.@.@.e.e.e.e.e.e.e......................",
        "...e.@.e.e.e.e.e.@.e.e.e.e.e.e.@...e@e@@e@@e@@e@e@@e@@e@..",
        "w..@.e.@.e.@.@.@.e.e.e.@.@.@.@.e.e.e.....................w",
        "...e.e.e.@.e.e.e.e.@.@.e.e.e.e.e.@.@.@@e@@e@@e@@e@@e@@e@..",
        "...e.@.e.e.e.e.e.@.e.e.e.e.e.e.@.e.e.e....................",
        "w..@.e.@.e.@.@.@.e.e.e.@.@.@.@.e.e.e.@e@e@@e@@e@@e@@e@@e.w",
        "...e.e.e.@.e.e.e.e.@.@.e.e.e.e.e.@.@.e.e..................",
        "...e.@.e.e.e.e.e.@.e.e.e.e.e.e.@.e.e.e.@e@@e@@e@@e@e@@e@..",
        "w..@.e.@.e.@.@.@.e.e.e.@.@.@.@.e.e.e.@.e.................w",
        "...e.e.e.@.e.e.e.e.@.@.e.e.e.e.e.@.@.e.e.@.@@e@@e@@e@@e@..",
        "...e.@.e.e.e.e.e.@.e.e.e.e.e.e.@.e.e...@.e.e..............",
        "w..@.e.@.e.@.@.@.e.e.e.@.@.@.@.e.e.e.e.e.e.@.@@e@@ee@@e@.w",
        "...e.e.e.@.e.e.e.e.@.@.e.e.e.e.e.@.@.@.e.@.e.e............",
        "...e.@.e.e.e.e.e.@.e.e.e.e.e@e.@.e.e.e.@.e.@.e.@.@@e@@e@..",
        "w..@.e.@.e.@.@.@.e.e.e.@.@.e.e.e.e.e.e.e.e.e.@.e.e.......w",
        "...e.e.e.@.e.e.e.e.@.@.e.e.@.@.e.@.@.@.e.@.e.e.e.@.@.@e@..",
        "...e.@.e.e.e.e.e.@.e.e.e.e.e.e.@.e.e.e.@.e.@.@.@.e.e......",
        "w..@.e.@.e.@.@.@.e.e.e.@.@.e.e.e.e.e.e.e.e.e.e.e.e.e.@@e.w",
        "...e.e.e.@.e.e.e.e.@.@.e.e.@.@.e.@.@.@.e.@.e.e.e.@.@.e.e..",
        "...e.@.e.e.e.e.e.@.e.e.e.e.e.e.@.e.e.e.@.e.@.@.@.e.e.@.@..",
        "w..@.e.@.e.@.@.@.e.e.e.@.@.e.e.e.e.e.e.e.e.e.e.e.e@e.e...w",
        "...e.e.e.@.e.e.e.e.@.@.e.e.@.@.e.@.@.@.@.@................",
        "...e.@.e.e.e.e.e.@.e.e.e@e.e.e.@.e.e.e.e.e@@e@@e@@e@@e@e..",
        "w..@.e.@.e.@.@.@.e.......................................w",
        "...e.e.e.@.e.e.e.e@@e.@ee@@e@e@@e@@e@@e@e@@e@@e@@e@@e@@e..",
        "...e.@.e.e................................................",
        "w..@.e.@.e.e@@e..e@@e@@e@@e@e@@e@@e@@e@@e@@e@@e@@e@@e@@e.w",
        "...e.e.e.@................................................",
        "...e.@.e.e.e@ee@@e@e@@e@@ee@@e@@e@@e@@e@@e@@e@@e@@e@e@@e..",
        "w..@.e.@.e...............................................w",
        "...e.e.e.@.e@@ee@e@@e@@e@.@e@@e@@e@@ee@@e@@e@e@@e@@e@@e@..",
        "...e.@.@.e................................................",
        "w..@.e.e.e.e@..@e@..@e@@e@e@@e@@e@@ee@@e@.@e@@e@@e@e@@e@.w",
        "...e.e.e.@................................................",
        "...e.@.@.e.e@e@@ee@@e@e@ee@@e@@e@@e@@e@@e@e@@e@@e@@e@@e@..",
        "w..@.e.e.e...............................................w",
        "...e.e.e.@.e@@e@@e@@e@e@@e@@e@@e@@e@@e@@e@@e@@e@@e@@e@e@..",
        "...e.@.@.e................................................",
        "w..@.e.e.e.e@@e@@e@@e@@e@@e@@e@@e@e@@e@@e@@e@@e@@e@@e@@e.w",
        "...e.e.e.@................................................",
        ".....@.@.e.e@e@e@e@e@.@e@@e@@e@@e@@e@@e@@e@@e@@e@@e@@ee@..",
        "w..e.e.e.e...............................................w",
        "...@.e.e.@.@e@@e@@e@e@@e@@e@@e@@e@@e@@e@@e@e@@e@@e@@e@e@..",
        "...e.@.@.e................................................",
        "w.@e.e.e.e@@e@@e@@e@@e@@e@@e@@e@@e@@e@e@@e@@e@@e@@e@@e@..w",
        ".........................................................."
    ],
    "nca_runtime": 0.10716366767883301,
    "milp_runtime": 6.761673927307129,
    "nca_milp_runtime": 6.868837594985962,
    "sim_score": null,
    "weight": false,
    "n_row": 57,
    "n_col": 58,
    "n_endpoint": 750,
    "n_agent_loc": 0,
    "n_shelf": 700,
    "maxtime": 5000
}