{
    "name": "kiva_57x58_cma-mae_opt_entropy_uneven_throughput_hamming_a=1",
    "layout": [
        "..........................................................",
        "w.e@e@e@e@e@e@e@e@e@e@e@e@e@e@e@e@e@e@e@e@e@e@e@e@e@e.e@.w",
        "..........................................................",
        "..e@e@e@e.e@e@e@e@e@e@e@e.e@e@e@e@e@e@e@e@e@e@...@e@......",
        "w........................................................w",
        "..e@e@e@e@e@e@e@e@e@e@e@e.e@e....e@@e@@ee@@e@e@.@e@e@@e...",
        "..........................................................",
        "w.e@e@e@e@e@e@e@e@e@e@e@e@e@e.@e.e@e@e@e@e@e@e@e@e@e@@e..w",
        "..........................................................",
        "..e@e@e.e@e@e@e@e@e@e.......@e.e@e@e@e@e@e@e@e@e@e@e@@e@..",
        "w........................................................w",
        "..e@e@e.e@e@e.e@..........@e@e@e@e@e@e@e@e@e@e@e@e@e@ee@..",
        "..........................................................",
        "w.e@e@e@e@e@@e..e@@e@e@e@e@e@e@e@e@e.e@e@e@e@e@e@e@e@ee@.w",
        "..........................................................",
        "..e@e@e@......@e@e@e@e@e@e@e@e@e@e@e@e@e@.@e@e@e@e@e@e@...",
        "w........................................................w",
        "..e@e@e@..@e@e@e@e.e@e@e@e@e@e@e@e@@e@e@e@..@e.@e@..@ee@..",
        "..........................................................",
        "w.e@e@e@e@@e@e@e@e@e@e@e@e@e@e@e@e...@e@.@e@e@e@e@....e@.w",
        "..........................................................",
        "..e@e@e@@e@e@e@e@e@e@e@e@e@e@e@e@e@e@e.@e@@e.@e@e@@e@@e@..",
        "w........................................................w",
        "..e@e@e@e@@e@e@e@e@e@e@e@e@e@e@e@e@e.@e@e@..e@.@e@e@e@e...",
        "..........................................................",
        "w.e@e@..@e@e@e@e@e@e@e@e@e@e@e@@e@@e@@e@..@e@e.e@e@@e@e@.w",
        "..........................................................",
        "..e@e@@e@e@e.e@e@e@e@e@e@e@e@e@e@e@e@e@.@e@e@e@e@@e@e@e@..",
        "w........................................................w",
        "..e@..@e@e@e@e@e@e@e@e@e@...@e@e@e@e@e@e@e@e@e@e@@e@e@e@..",
        "..........................................................",
        "w.e@.e@...@e@@ee@.@e@@e@@e.@ee@e@e@e@e@e@e@e@e@@e@.@e@e@.w",
        "..........................................................",
        "..e@e@@e@.@e.e@......e@@e@e@e@@e@e@e@e...e@@e.e@@e@@e@e@..",
        "w........................................................w",
        "..e@e.@e@@e@e@e@e@e@e@e@e@.e@.e@e@e@e@.@e@e@e@@e@e@@e@e@..",
        "..........................................................",
        "w.e@e@..@e@@e@e@e@e@e@e@..@e@..@e@e@e@e@e@e@e@@e@e@e@....w",
        "..........................................................",
        "..e@e@e@ee@@e@e@e@e@e@e@.e@e@e@e@@e@e@..@e@e@e@e@e@e@@e@..",
        "w........................................................w",
        "..e@e.e@e@.@ee@@e@e@e@e@.e@e@e@..@e.e@e@@e@e@e@e@e.@e@e@..",
        "..........................................................",
        "w.e@e@e@e@@e@e@e@..@e@e@@e@e@..@e@e@e@@e@e@e@e@e@e@e@ee@.w",
        "..........................................................",
        "..e@e@e@ee@..@e@e@e@e@e@e@e@e@e@e@e@e@@e@e@e@e@e@e@e@ee@..",
        "w........................................................w",
        "..e@e@e.e@e..@e@e@e@e@e@e@e@e@e@e@e@e@e@e@@e@e@e@e@e@e....",
        "..........................................................",
        "w.e@e.e@e@e@e.e@e@e@e@e@e@e@e@e@e@e@e@e@e@e@e@e@@e@e@e@..w",
        "..........................................................",
        "..e@e@e@e@e@e@e@e@e@e@e@e@e@e@e@e@e@e@e@e@e@e@.e@e@e@e@...",
        "w........................................................w",
        "..e@e@e@e@e@e@e@e@e@e@e@e@e@e@e@e@e@e@e@e@e@e@ee@e@.@e@...",
        "..........................................................",
        "w.e@e@e@e@e@e@e@e@e@e@e@e@e@e@e@e@e@e@e@e@e@e@ee@ee@..@e.w",
        ".........................................................."
    ],
    "nca_runtime": 0.11186861991882324,
    "milp_runtime": 5.041191577911377,
    "nca_milp_runtime": 5.1530601978302,
    "sim_score": null,
    "weight": false,
    "n_row": 57,
    "n_col": 58,
    "n_endpoint": 663,
    "n_agent_loc": 0,
    "n_shelf": 700,
    "maxtime": 5000
}