{
    "name": "kiva_69x69_cma-mae_opt_entropy_uneven_throughput_hamming_a=1",
    "layout": [
        ".....................................................................",
        "w.e@e@e@e@e@e@e@e.e@e@e@e@e@e@e@e@e@@e@@e@@ee@@e@@e@@e@@e@@e@@e@@e@.w",
        ".....................................................................",
        "..e@e@e@e@e@e.e@e@e.e@e@e@e@e@e@e@e@e@@e@@e@@e@@e@@ee@@e@.@e@@ee@@e..",
        "w...................................................................w",
        "..e@e@e@e@e@e.e@e@e.e@e@e@e@e@e@e@e@ee@@e@@e@@e@@e@@e@e@@e@@e@e@@e@..",
        ".....................................................................",
        "w.e@e@e@e@e@e.e@e@e@e@e@e@e@e@e@e@e@e@e@e@e@e@e@e@e@e@e@e@e@e@e@@e..w",
        ".....................................................................",
        "..e@e.e@e@e@e@e@e@e@e.e@e@e@e.e@e@e@e@e.e@e@e@e@e@e@e@e@e@e@e@e@@e@..",
        "w...................................................................w",
        "..e@e@e@e@e@e@e@e@e@e@e@e@e@e@e@e@e@e@e@e@e@e@e@e@e@e.e@e@e@e@e@e@e..",
        ".....................................................................",
        "w.e@e@e@e@e@e@e@e@e@e@e@e@e@e@e@e@e@e@e@e@e@e@e@e@e@e@e@e@e@e@e.e@..w",
        ".....................................................................",
        "..e@e@e@e@e@e.e@e@e@e@e@e.e@e@e@e@e.e@@e@e@e@@e@e@e@e@e@e@e@e@e@e....",
        "w...................................................................w",
        "..e@e.e@e..@e...e@e@e@e@e.e@e@e@e@e@e@.e@e@@e@e@.@e.e@e@e...@e@@e@...",
        ".....................................................................",
        "w.e@e@e@e.....@ee@e@e@e@e@e@e.e@e@e@e@@e@e@e@@e@@e.@e@e.e@@e@....e@.w",
        ".....................................................................",
        "..e@e@e@e@...@e@e@e@e.e@e@e@e.e@e@e@e@e.e@@e@e@e@e@e@@e@e@@e@e@.@e@..",
        "w...................................................................w",
        "..e@e.e@e@e@e@e@e@e@e@e@e@e@e@e@e@e@e@@ee@e@e@e@@e@e@@e@e.@e@e@e@e@..",
        ".....................................................................",
        "w.e@e@e@e@e@e@e@e@e@e@e@e@e@e@e@e@e@e@e@@e@e@@e@e@@e@@ee@@e@@e@e@e..w",
        ".....................................................................",
        "..e@e@e@e@e@e@e@e@e@e@e@e@e@e@e@e@e@e@e@e@@e@@e@@e@e@e@e@e@e@e@e@e...",
        "w...................................................................w",
        "..e@e@e@e@e@e@e@e@e@e@e@e@e@e@e@e@e@e@e.e@.@e@@e@e@e@e@e@e@e@e@e@e@..",
        ".....................................................................",
        "w.e@e@e.e@e@e@e@e@e@e@e@e@e@e@e.e@e@@ee@e@@e@e@e.e@e@e@e@e@e@e@e@e@.w",
        ".....................................................................",
        "..e@e@e@e@e@e@e@e@e@e@e.e@e@e@e@e@e@e@e@e@@e@e@e@e@e@e@e@e@e@e@e@e@..",
        "w...................................................................w",
        "..e@e@e.e@e@e@e@e@e@e@e@e@e@e....@e@e@e.e@e@e@@e@e@e@e@e@e@e@e.e@e@..",
        ".....................................................................",
        "w.e@e@e.....e@e@...@e.......e@@e....e@e@e@e.e@e@@e@e@e@e@e@e@e@e@e@.w",
        ".....................................................................",
        "..e@e.e@...........@e..@e..@ee@e@e....e@e@e@@e@e@e@e@e@e.e@e@e@e@e@..",
        "w...................................................................w",
        "..e@e@e..e@e@e.e@e@e@e@e@e@e@e....e@@e@ee@..@e@e@e@e.e@e@e@e@e@e@e@..",
        ".....................................................................",
        "w.e@e@e..@ee@e@e@e@e.e@e@e@.....e@..@e@ee@@ee@@e@e@e@..@e@@e@e.e@e@.w",
        ".....................................................................",
        "..e@e@e@e...@e.e@e@e@e@e@e@..@e@e@...e@ee@.@e@@e@e@e@e@..@ee@e@e@e@..",
        "w...................................................................w",
        "..e@e@e@e@e...@e@e@e@e@e@e@.e@e@e@@e.e@.@e@@e@e@@e@e@e@e@e@e@e@e@e@..",
        ".....................................................................",
        "w.e@e@e@e@e@e.....@e@e@e@@e@e@e@e@..@ee@@ee@@e@e@e@e@e@e@e@e@e@e@@e.w",
        ".....................................................................",
        "..e@e@e@e@e@e@e@ee@..e@e@@e@e@e@..@e@e@.@ee@e@e.e@@e@.e@@e@.@e@@e@...",
        "w...................................................................w",
        "..e@e@e.e@e@e@e@ee@@ee@..@e@e@ee@@ee@e.e@@e@e.e@@e@...e@e@@e@@e@ee@..",
        ".....................................................................",
        "w.e@e@e@e@e.e@e.e@.@ee@e@e@.e@e.@e@e@e@@e@e@e@.@e...e@e@@e@e@@e@ee@.w",
        ".....................................................................",
        "..e@e@e@e@e@e@e@e@e@@e@e@e@.e@ee@@ee@e@@e@e@e@@e@.e@e@@e@e@.e@e@ee@..",
        "w...................................................................w",
        "..e@e.e@e@e@e@e@e@@e@e@e@@e@e@e@@e@e@e@@e@e@e@@e@@e@e@e@.@e@e@e@ee@..",
        ".....................................................................",
        "w.e@e@e@e@e@e@e@e@e@e@e.e@e@e@e@@e@e@e@e@@e@e@..@e@e@e@e@e@@e@e@e@e.w",
        ".....................................................................",
        "..e@e@e@e@e@e@e.e@e@e@e@e@e@e@e@@e@e@e@e@@e@e@.e@e@e@e@e@@e@e@e@ee@..",
        "w...................................................................w",
        "..e@e@e@e.e@e@e@e@e@e@e@e@e@e@e@@e@e@e@@e@e@e@.e@e@e@e.e@@e@e@.@e@...",
        ".....................................................................",
        "w.e@e@e@e@e@e@e@e@e@e@e@e@e@e@ee@.@e.e@@e@e@e@@e@e@e@e@e@@e@@e@.@e@.w",
        "....................................................................."
    ],
    "nca_runtime": 0.11776375770568848,
    "milp_runtime": 7.572164058685303,
    "nca_milp_runtime": 7.689927816390991,
    "sim_score": null,
    "weight": false,
    "n_row": 69,
    "n_col": 69,
    "n_endpoint": 987,
    "n_agent_loc": 0,
    "n_shelf": 1020,
    "maxtime": 5000
}