{
    "name": "kiva_81x80_cma-mae_opt_entropy_throughput_hamming_a=1",
    "layout": [
        "................................................................................",
        "w.@e@@ee@e@@e@@e@@e@@e@@e@@e@.e@@e@@e@@e@@e@@e@@e@@e@@e@@e@@e@@e@@e@@e@@e@@e@e.w",
        "................................................................................",
        "..@e@@e@@e@@e@@e@@ee@e@@e@@e@@e@@e@@e@@e.@ee@@e@@e@@e@@e@@e@@e@@e@@e@@e@@e@@e@..",
        "w..............................................................................w",
        "..@e@@e@@e@@e@@e@@e@@e@@e@@e@e@@e@@e@@e@@e@@e@@e@@e..e@@e@@e@@ee@@e@@e@@e@@ee@..",
        "................................................................................",
        "w.@e@e@@e@@e@@e@@e@@e@e@@ee@@e@e@@e.e@e@@e@@e@@e@@e@@e@@e@@e@@ee@@e@@e@@e@@e@..w",
        "................................................................................",
        "..@e@@e@@e@@e@@e@e@@e@@e@e@@e.e@ee@ee@ee@ee@ee@ee@ee@ee@ee@ee@ee@ee@ee@ee@ee@e..",
        "w..............................................................................w",
        "....@e@@e@@e@@e@@e@@e@@e@@e@@e@@e@@e@@e@@e@@e@@e@@e@e@e@@ee@@e@@e@@e@@e@e@@e@...",
        "................................................................................",
        "w.@e@@e@@e@@e@@ee@@e@@e@@e@@e@@e@e@@e@@e@@e@@e@@e@@ee@@e@@e@e@@e@@e@@e@@e@@e@..w",
        "................................................................................",
        "..@e@@e@@e@@e@e@e@@e@.@e@@e@@e@@e@@e@@e@@ee@@e@@e@@e@@e@@e@@e@@e@.@e@@e@@e@e@...",
        "w..............................................................................w",
        "..@e@e@@e@@e@@e@@e@@e@@e@@e@@e@@e@e@@e@@ee@@e@@e@@e@e@@e@@e@@e@@e@@e@@e@@e@e@...",
        "................................................................................",
        "w.@e@@e@@e@e@@e@@e@@e@@e@@e@@e@@e@@e@@e@@e@@e@@e@@e@ee@e@@e@@e@@e@@e@@e@@e@e@e.w",
        "................................................................................",
        "..e@@e@@ee@@e@@e@@e@@e@@e@@e@@e@@ee@@e@e@e@@e@@e@e@@e@@e@@e@@e@@e@@e@@e@@e@e@...",
        "w..............................................................................w",
        "..@e@@e@@e@@e@@e@@e@@e@@e@@e@@e@@e@@ee@@e@@ee@..e@e@@e@e@@e@@e@@e@@e@@e@e@@e@...",
        "................................................................................",
        "w.@e@@e@@e@@e@@e@@e@@e@@e@@e@@e@@e@@e@@e@@e@@e@@e@@e@@e@@e@@e@@e@@e@@e@@e@@e@..w",
        "................................................................................",
        "...@e@@e@e@@ee@ee@@e@@e@@e@@e@@e@@e@@e@@e@@e@.e@@e@@e@@e@.@e@@e@e@ee@@e@@e@@e...",
        "w..............................................................................w",
        "..@e@@e@@e@@ee@ee@e.e@@e@@e@@e@.@ee@e@ee@ee@ee@ee@ee@ee@ee@ee@ee@ee@ee@ee@ee@e..",
        "................................................................................",
        "w.@e@e@@e@e.e@ee@ee@e.e@@e@@e@@e@@e@@e@@e@@e@@e@@e@@e@e@@e@e@@e@@e@@e@@ee@@e@..w",
        "................................................................................",
        "..@e@.@ee@eee@ee@ee@ee@ee@@e@@e@@e@@e@@e.@e@@e@@e@@e@@e@@e@@e@@e@@e@ee@@e@@e@...",
        "w..........@...................................................................w",
        "..e@ee@ee@eee@ee@ee@ee@ee@ee@ee@ee@@e..@e@@e@@e@e@@e@@e@@e@@e@e@@e@@e@@e@e@@e...",
        "................................................................................",
        "w.@ee@ee@ee@ee@ee@ee@ee@ee@ee@ee@ee@@ee@@e@@e@e@@e@@e@@e@.@e@@e@@e@@e@@e@@e@@e.w",
        "................................................................................",
        "..e@e.e@ee@ee@ee@ee@ee@ee@ee@ee@ee@ee@ee@ee@ee@ee@ee@ee@ee@ee@ee@ee@ee@ee@ee@e..",
        "w..............................................................................w",
        "...e@ee@ee@ee@ee@ee@ee@ee@ee@ee@ee@ee@ee@ee@ee@ee@ee@ee@ee@ee@ee@ee@ee@ee@ee@e..",
        "................................................................................",
        "w.ee@ee@ee@ee@ee@ee@ee@ee@ee@ee@ee@ee@ee@ee@ee@ee@ee@ee@ee@ee@ee@ee@ee@ee@ee@e.w",
        "..@.............................................................................",
        "..ee@ee@ee@ee@ee@ee@ee@ee@ee@ee@ee@ee@ee@ee@ee@ee@ee@ee@ee@ee@ee@ee@ee@ee@ee@e..",
        "w..............................................................................w",
        "..e@ee@ee@ee@ee@eee@ee@ee@ee@ee@ee@ee@ee@ee@ee@ee@ee@ee@ee@ee@ee@ee@ee@ee@ee@e..",
        ".................@..............................................................",
        "w.e@ee@ee@ee@ee@eee@ee@ee@ee@ee@ee@ee@ee@ee@ee@ee@ee@ee@ee@ee@ee@ee@ee@ee@ee@e.w",
        "................................................................................",
        "..ee@ee@ee@ee@ee@ee@ee@ee@ee@ee@ee@ee@ee@ee@ee@ee@ee@ee@ee@ee@ee@ee@ee@ee@ee@e..",
        "w.@............................................................................w",
        "..ee@ee@ee@ee@ee@ee@ee@ee@ee@ee@ee@ee@ee@ee@ee@ee@ee@ee@ee@ee@ee@ee@ee@ee@ee@e..",
        "................................................................................",
        "w.e@ee@eee@ee@ee@ee@ee@ee@ee@ee@ee@ee@ee@ee@ee@ee@ee@ee@ee@ee@ee@ee@ee@ee@ee@e.w",
        "........@.......................................................................",
        "..e@ee@eee@ee@ee@ee@ee@ee@ee@ee@ee@ee@ee@ee@ee@ee@ee@ee@ee@ee@ee@ee@ee@ee@ee@e..",
        "w..............................................................................w",
        "..ee@ee@ee@ee@ee@ee@ee@ee@ee@ee@ee@ee@ee@ee@ee@ee@ee@ee@ee@ee@ee@ee@ee@ee@ee@e..",
        "..@.............................................................................",
        "w.ee@ee@ee@ee@ee@ee@ee@ee@ee@ee@@e@@e@@e@@e@@e@@e@@e@@e@@e@@e@@e@@e@@e@@e@@e@..w",
        "................................................................................",
        "..e@ee@ee@ee@ee@ee@ee@ee@ee@ee@ee@@e@@e@@e@@e@@e@@e@@e@@e@@e@@e@e@@e@@e@@e@@e...",
        "w..............................................................................w",
        "..e@ee@ee@ee@ee@ee@ee@ee@ee@ee@ee@ee@ee@ee@ee@ee@ee@ee@ee@ee@ee@ee@ee@ee@eee@e..",
        "..........................................................................@.....",
        "w.e@ee@ee@ee@ee@ee@ee@ee@ee@ee@ee@ee@ee@ee@ee@ee@ee@ee@ee@ee@ee@ee@ee@ee@eee@e.w",
        "................................................................................",
        "..ee@ee@ee@ee@ee@ee@ee@ee@ee@ee@ee@ee@ee@ee@ee@ee@ee@ee@ee@ee@ee@ee@ee@ee@ee@e..",
        "w.@............................................................................w",
        "..ee@ee@ee@ee@ee@ee@ee@ee@ee@ee@ee@ee@ee@ee@ee@ee@ee@ee@ee@ee@ee@ee@ee@ee@ee@e..",
        "................................................................................",
        "w.e@ee@ee@ee@ee@ee@ee@ee@ee@ee@ee@ee@ee@ee@ee@ee@ee@ee@eee@ee@ee@ee@ee@ee@ee@e.w",
        "........................................................@.......................",
        "..e@ee@ee@ee@ee@ee@ee@ee@ee@ee@ee@ee@ee@ee@ee@ee@ee@ee@eee@ee@ee@ee@ee@ee@ee@e..",
        "w..............................................................................w",
        "..e@ee@ee@ee@e.e@ee@ee@ee@ee@ee@ee@ee@ee@ee@ee@ee@ee@ee@ee@ee@ee@ee@ee@ee@ee@e..",
        "................................................................................",
        "w.e@ee@e.e@ee@ee@ee@ee@ee@ee@ee@ee@ee@ee@ee@ee@ee@ee@ee@ee@ee@ee@ee@ee@ee@ee@e.w",
        "................................................................................"
    ],
    "nca_runtime": 0.12888503074645996,
    "milp_runtime": 242.9783580303192,
    "nca_milp_runtime": 243.10724306106567,
    "sim_score": null,
    "weight": false,
    "n_row": 81,
    "n_col": 80,
    "n_endpoint": 1607,
    "n_agent_loc": 0,
    "n_shelf": 1400,
    "maxtime": 5000
}