{
    "name": "kiva_81x80_cma-mae_opt_entropy_uneven_throughput_hamming_a=5",
    "layout": [
        "...e............................................................................",
        "w..@.@.@.@.@.@.@.@.@.@.@.@.@.@.@.@.@.@.@.@.@.@.@.@.@.@.@.@.@.@.@.@.e@@e@@.@.@e.w",
        "...e.e.e.e.e.e.e.e.e.e.e.e.e.e.e.e.e.e.e.e.e.e.e.e.e.e.e.e.e.e.e.e......e.e.e...",
        "...e.e.e.e.e.e.e.e.e.e.e.e.e.e.e.e.e.e@e.e@e.e..................................",
        "w..@.@.@.@.@.@.@.@.@.@.@.@.@.@.@.@.@.e.e.e.e.@.e@@e@@e@@e@@e@@ee@e@@ee@@e@e@e@.w",
        "...e.e.e.e.e.e.e.e.e.e.e.e.e.e.e.e.e.@.@.@.@.e.e................................",
        "...e.e.e.e.e.e.e.e.e.e.e.e.e.e.e.e.e.e.e.e.e.e.@@e@@e@@e@@ee@@e@@e@@e@@e@@e@@e..",
        "w..@.@.@.@.@.@.@.@.@.@.@.@.@.@.@.@.@.e.e.e.e.@.................................w",
        "...e.e.e.e.e.e.e.e.e.e.e.e.e.e.e.e.e.@.@.@.@.e.@@e@@e@@e@@e@@e@@e@@e@@e@@e@@e@..",
        "...e.e.e.e.e.e.e.e.e.e.e.e.e.e.e.e.e.e.e.e.e.e.e................................",
        "w..@.@.@.@.@.@.@.@.@.@.@.@.@.@.@.@.@.e.e.e.e.@.@@e@@e@@e@@e@@e@@e@@e@@e@@e@@e@.w",
        "...e.e.e.e.e.e.e.e.e.e.e.e.e.e.e.e.e.@.@.@.@.e.e.e..............................",
        "...e.e.e.e.e.e.e.e.e.e.e.e.e.e.e.e.e.e.e.e.e.e.e.@@e@@e@@e@@e@.@e@@e@@e@@e@@e@..",
        "w..@.@.@.@.@.@.@.@.@.@.@.@.@.@.@.@.@.e.e.e.e.@.@.e.e...........................w",
        "...e.e.e.e.e.e.e.e.e.e.e.e.e.e.e.e.e.@.@.@.@.e.e.@.@@e@@e@@e@@e@e@@e@@e@@e@@e@..",
        "...e.e.e.e.e.e.e.e.e.e.e.e.e.e.e.e.e.e.e.e.e.e.e.e.e............................",
        "w..@.@.@.@.@.@.@.@.@.@.@.@.@.@.@.@.@.e.e.e.e.@.@.e.@.@@e@@e@@e@@e@@e@@e@@e@@e@.w",
        "...e.e.e.e.e.e.e.e.e.e.e.e.e.e.e.e.e.@.@.@.@.e.e.@.e.e..........................",
        "...e.e.e.e.e.e.e.e.e.e.e.e.e.e.e.e.e.e.e.e.e.e.e.e.e.e@@e@@e@@e@@e@@e@@e@@e@e@..",
        "w..@.@.@.@.@.@.@.@.@.@.@.@.@.@.@.@.@.e.e.e.e.@.@.e.@...........................w",
        "...e.e.e.e.e.e.e.e.e.e.e.e.e.e.e.e.e.@.@.@.@.e.e.@.e.e@e@@e@@e@@e@@e@@e@@e@@e@..",
        "...e.e.e.e.e.e.e.e.e.e.e.e.e.e.e.e.e.e.e.e.e.e.e.e.e.e..........................",
        "w..@.@.@.@.@.@.@.@.@.@.@.@.@.@.@.@.@.e.e.e.e.@.@.e.@.@@e@@e@@e@@e@@e@@e@@e@@e@.w",
        "...e.e.e.e.e.e.e.e.e.e.e.e.e.e.e.e.e.@.@.@.@.e.e.@.e.e..........................",
        "...e.e.e.e.e.e.e.e.e.e.e.e.e.e.e.e.e.e.e.e.e.e.e.e.e.e@@e@@e@@e@@e@@e@@e@@e@e@..",
        "w..@.@.@.@.@.@.@.@.@.@.@.@.@.@.@.@.@.e.e.e.e.@.@.e.@.e.........................w",
        "...e.e.e.e.e.e.e.e.e.e.e.e.e.e.e.e.e.@.@.@.@.e.e.@.e.@@e@@e@@e@@e@@e@@e@@e@@e@..",
        "...e.e.e.e.e.e.e.e.e.e.e.e.e.e.e.e.e.e.e.e.e.e.@.e..............................",
        "w..@.@.@.@.@.@.@.@.@.@.@.@.@.@.@.@.@.e.e.e.e.@.e.e@@e.e@@e@e@@e@@e@@e@e@@e@@e@.w",
        "...e.e.e.e.e.e.e.e.e.e.e.e.e.e.e.e.e.@.@.@.@.e..................................",
        "...e.e.e.e.e.e.e.e.e.e.e.e.e.e.e.e.e.e.e.e.e.e@@e@@e@.@e@@e@@e@@e@@e@@e....e@...",
        "w..@.@.@.@.@.@.@.@.@.@.@.@.@.@.@.@.@.e.e.e.e...................................w",
        "...e.e.e.e.e.e.e.e.e.e.e.e.e.e.e.e.e.@.@.@.@.e@e@@e@@e@@e@@e@@e@@e@e@@e@e@@e@...",
        "...e.e.e.e.e.e.e.e.e.e.e.e.e.e.e.e.e.e.e.e.e....................................",
        "w..@.@.@.@.@.@.@.@.@.@.@.@.@.@.@.@.@.e.e.e.e.e@@e@e@@e@@e@@e@e@@e@@e@@e@@e@@e@.w",
        "...e.e.e.e.e.e.e.e.e.e.e.e.e.e.e.e.e.@.@.@.@.e..................................",
        "...e.e.e.e.e.e.e.e.e.e.e.e.e.e.e.e.e.e.e.e.e.@.@e@@e@@e@@e@@e@@e@@e@@e@.@e@@e@..",
        "w..@.@.@.@.@.@.@.@.@.@.@.@.@.@.@.@.@.e.e.e.e.e.................................w",
        "...e.e.e.e.e.e.e.e.e.e.e.e.e.e.e.e.e.@.@.@.@.@.@@e@e@@e@@e@@e@@ee@@e@@e@@e@@e@..",
        "...e.e.e.e.e.e.e.e.e.e.e.e.e.e.e.e.e.e.e.e.e.e.e................................",
        "w..@.@.@.@.@.@.@.@.@.@.@.@.@.@.@.@.@.e.e.e.e.e.@ee@@e@@e@@e@@e@@e@@e@@e@@e@@e@.w",
        "...e.e.e.e.e.e.e.e.e.e.e.e.e.e.e.e.e.@.@.@.@.@.e.e..............................",
        "...e.e.e.e.e.e.e.e.e.e.e.e.e.e.e.e.e.e.e.e.e.e.e.@@e@@e@@e@.@e@@e@@e@@e@@e@@e@..",
        "w..@.@.@.@.@.@.@.@.@.@.@.@.@.@.@.@.@.e.e.e.e.e.@.e.............................w",
        "...e.e.e.e.e.e.e.e.e.e.e.e.e.e.e.e.e.@.@.@.@.@.e...@@e@@e@@e@@e@@e@@e@@e@e@@e@..",
        "...e...e.e.e.e.e.e.e.e.e.e.e.e.e.e.e.e.e.e.e.e.e.e.e............................",
        "w..@.e.@.@.@.@.@.@.@.@.@.@.@.@.@.@.@.e.e.e.e.e.@.@.e.@@e@.@e@@e@@e@@e@e@@e@@e@.w",
        "...e.@.e.e.e.e.e.e.e.e.e.e.e.e.e.e.e.@.@.@.@.@.e.e.@.e..........................",
        "...e.e.e.e.e.e.e.e.e.e.e.e.e.e.e.e.e.e.e.e.e.e.e.e.e.e.@@e@@e@@e@@e@@e@@e@.@e@..",
        "w..@.e.@.@.@.@.@.@.@.@.@.@.@.@.@.@.@.e.e.e.e.e.@.@.e.@.e.......................w",
        "...e.@.e.e.e.e.e.e.e.e.e.e.e.e.e.e.e.@.@.@.@.@.e.e.@.e...@@e@@e@@e@e@@e@@e@@e@..",
        "...e.e.e.e.e.e.e.e.e.e.e.e.e.e.e.e.e.e.e.e.e.e.e.e.e.e.e.e......................",
        "w..@.e.@.@.@.@.@.@.@.@.@.@.@.@.@.@.@.e.e.e.e.e.@.@.e.@.@.e.@@e@@e@@e@@e@@e@@e@.w",
        "...e.@.e.e.e.e.e.e.e.e.e.e.e.e.e.e.e.@.@.@.@.@.e.e.@.e.e.@.e....................",
        "...e.e.e.e.e.e.e.e.e.e.e.e.e.e.e.e.e.e.e.e.e.e.e.e.e.e.e.e.e.e@@e@@e@@e@@e@@e@..",
        "w..@.e.@.@.@.@.@.@.@.@.@.@.@.@.@.@.@.e.e.e.e.e.@.@.e.@.@.e.@.e.................w",
        "...e.@.e.e.e.e.e.e.e.e.e.e.e.e.e.e.e.@.@.@.@.@.e.e.@.e.e.@.e.@..e@@e@@e@@e@@e@..",
        "...e.e.e@e.e.e.e.e.e.e.e.e.e.e.e.e.e.e.e.e.e.e.e@e.e.e.e.e...e.e................",
        "w..@.e.e.e.@.@.@.@.@.@.@.@.@.@.@.@.@.e.e.e.e.e.e.e.e.@.@.e.e@e.@.e@@e@@.@.@.@..w",
        "...e.@.@.@.e.e.e.e.e.e.e.e.e.e.e.e.e.@.@.@.@.@.@.@.@.e.e.@.e.e.e......e.e.e.e...",
        "...e.e.e.e.e.e.e.e.e.e.e.e.e.e.e.e.e.e.e.e.e.e.e.e.e.e@e.e.@.@..................",
        "w..@.e.e.e.@.@.@.@.@.@.@.@.@.@.@.@.@.e.e.e.e.e.e.e.e.e.e.e.e.e.e@@e@.@e@@e@@e@.w",
        "...e.@.@.@.e.e.e.e.e.e.e.e.e.e.e.e.e.@.@.@.@.@.@.@.@.@.@.@.e....................",
        "...e.e.e.e.e.e.e.e.e.e.e.e.e.e.e.e.e.e.e.e.e.e.e.e.e.e.e.e.@@e@@e@@e@@e@@e@@e@..",
        "w..@.e.e.e.@.@.@.@.@.@.@.@.@.@.@.@.@...........................................w",
        "...e.@.@.@.e.e.e.e.e.e.e.e.e.e.e.e.e.e@@e@@e@@e@@e@@e@@e@@e@@e@@e@@e@@e@@e@@e@..",
        "...e.e.e.e......................................................................",
        "w..@.e.e.e.e@@e@@e@@e@@e@@e@@e@@e@@e@@e@@e@@e@@e@@e@@e@@e@@e@@e@@e@e@@e@@e@@e@.w",
        "...e.@.@.@......................................................................",
        "...e.e.e.e.e@@e@@ee@@e@@e@@e@@e@@e@e@@e@@e@@e@@e@@e@@e@@e@@e@@e@@e@@e@@e@@e@@e..",
        "w..@.e.e.e.....................................................................w",
        "...e.@.@.@.e@@e@@e@@e@@e@@e@@e@@e@@e@@e@@e@e@@e@@e@@e@@e@@e@@e@@e@@e@@e@@e@@e@..",
        "...e.e.e.e......................................................................",
        "w..@.e.e.e.e@@e@@e@@e@@e@@e@@e@@e@@e@@e@@e@@e@@e@@e@@e@@e@e@@e@@e@@e@@e@@e@@e@.w",
        "...e.@.@.@......................................................................",
        ".....e.e.e.e@@e@@e@@e@@e@@e@@e@@e@@e@@e@@e@@e@@e@@e@@e@@e@@e@@e@@e@@e@@e@@e@e@..",
        "w..e.e.e.e.....................................................................w",
        "...@.@.@.@.@e@@e@@e@@e@@e@@e@@e@@e@@e@@e@@e@@e@@e@@e@@e@@e@@e@@e@@e@@e@@e@@ee@..",
        "...e.e.e.e......................................................................",
        "w.@e.e@e.e@@e@@e@@e@@e@@e@@e@@e@@e@e@@e@@e@@e@@e@@e@@e@@e@@e@@e@@e@@e@e@@e@@e@.w",
        "................................................................................"
    ],
    "nca_runtime": 0.11407279968261719,
    "milp_runtime": 114.38815331459045,
    "nca_milp_runtime": 114.50222611427307,
    "sim_score": null,
    "weight": false,
    "n_row": 81,
    "n_col": 80,
    "n_endpoint": 1560,
    "n_agent_loc": 0,
    "n_shelf": 1400,
    "maxtime": 5000
}