{
    "name": "kiva_57x58_cma-mae_opt_entropy_throughput_hamming_a=5",
    "layout": [
        "..........................................................",
        "w.e@ee@@ee@@ee@@ee@@ee@@ee@@ee@@ee@@ee@@ee@@ee@@ee@@e.e@.w",
        "..........................................................",
        "...@ee@@ee@@ee@@ee@@ee@@ee@@ee@@ee@@ee@@ee@@ee@@ee@.e@e...",
        "w........................................................w",
        "..e@ee@@ee@@ee@@ee@@ee@@ee@e.e@@ee@@ee@@e..@ee@@ee@@e.e@..",
        "..........................................................",
        "w..@ee@@ee@@ee@@ee@@ee@@ee@@e..@ee@@ee@@ee@@ee@@ee@@ee@..w",
        "..........................................................",
        "...@ee@@ee@@ee@@ee@@ee@@ee@@ee@@ee@@ee@@ee@@ee@@ee@@ee@e..",
        "w........................................................w",
        "..e@ee@@ee@..e@@ee@@ee@@ee@@ee@@ee@@ee@@ee@@e..@ee@@e.e@..",
        "..........................................................",
        "w....e@@ee@@ee@@ee@@ee@@ee@@ee@@ee@@ee@@ee@@ee@@ee@@ee@..w",
        "..........................................................",
        ".....e@..e@@ee@@ee@@ee@@ee@@ee@@ee@@ee@@ee@@ee@@ee@@ee@e..",
        "w........................................................w",
        ".....e@..e@@ee@@ee@@ee@@ee@@ee@@ee@@ee@@ee@@ee@@ee@@e.e@..",
        "..........................................................",
        "w....e@@ee@@ee@@ee@@ee@@ee@@ee@@ee@@ee@@ee@@ee@@ee@@ee@..w",
        "..........................................................",
        "...@ee@@ee@@ee@@ee@@ee@@ee@@ee@@ee@@ee@@ee@@ee@@ee@@ee@e..",
        "w........................................................w",
        ".....e@@ee@@ee@@ee@@ee@@ee@@ee@@ee@@ee@@ee@@ee@@ee@@e.e@..",
        "..........................................................",
        "w....e@@ee@@ee@@e..@ee@@ee@@ee@@ee@@ee@@ee@@ee@@ee@@ee@..w",
        "..........................................................",
        "...@e..@e....e@@ee@@ee@@ee@@ee@@ee@@ee@@ee@@ee@@ee@@ee@e..",
        "w........................................................w",
        "...@ee@@e..@ee@@ee@@ee@@ee@@ee@@ee@@ee@@ee@@ee@@ee@@e.e@..",
        "..........................................................",
        "w....e@@ee@@ee@@ee@@ee@@ee@@ee@@ee@@ee@@ee@@ee@@ee@@ee@..w",
        "..........................................................",
        "..e@e..@ee@@ee@@ee@@ee@@ee@@ee@@ee@@ee@@ee@@ee@@ee@@ee@e..",
        "w........................................................w",
        "...@ee@@ee@@ee@@ee@@ee@@ee@@ee@@ee@@ee@@ee@@ee@@ee@@e.e@..",
        "..........................................................",
        "w....e@@ee@@ee@@ee@@ee@@ee@@ee@@ee@@ee@@ee@@ee@@ee@@ee@..w",
        "..........................................................",
        "...@ee@@ee@@ee@@ee@@ee@@ee@@ee@@ee@@ee@@ee@@ee@@ee@@ee@e..",
        "w........................................................w",
        "..e@ee@@ee@@ee@@ee@@ee@@ee@@ee@@ee@@ee@@ee@@ee@@ee@@e.e@..",
        "..........................................................",
        "w..@ee@@ee@@ee@@ee@@ee@@ee@@ee@@ee@@ee@@ee@@ee@@ee@@ee@..w",
        "..........................................................",
        "...@ee@@ee@@ee@@ee@@ee@@e....e@@ee@@ee@@ee@@ee@@ee@@ee@e..",
        "w........................................................w",
        ".......@e..@ee@@ee@@ee@@ee@@e..@ee@@ee@@ee@@ee@@ee@@e.e@..",
        "..........................................................",
        "w..@ee@@ee@@ee@@ee@@ee@@ee@@ee@@ee@@ee@@ee@@ee@@ee@@ee@..w",
        "..........................................................",
        "...@ee@@ee@@ee@@ee@@ee@@ee@@ee@@ee@@ee@@ee@@ee@@ee@@ee@e..",
        "w........................................................w",
        "..e@ee@@ee@@ee@@ee@@ee@@ee@@ee@@ee@@ee@@ee@@ee@@ee@@e.e@..",
        "..........................................................",
        "w..@ee@@ee@@ee@@ee@@ee@@ee@@ee@@ee@@ee@@ee@@ee@@ee@@ee@..w",
        ".........................................................."
    ],
    "nca_runtime": 0.10915780067443848,
    "milp_runtime": 6.0475311279296875,
    "nca_milp_runtime": 6.156688928604126,
    "sim_score": null,
    "weight": false,
    "n_row": 57,
    "n_col": 58,
    "n_endpoint": 716,
    "n_agent_loc": 0,
    "n_shelf": 700,
    "maxtime": 5000
}