{
    "name": "kiva_81x80_cma-mae_opt_entropy_uneven_throughput_hamming_a=1",
    "layout": [
        "................................................................................",
        "w.e@e@e@e@e@e@e@e@e.e@e@e@e.e@e@e@e@e@e@e@e@e@e@e@e@e@e@e@e@e@e@e@e@e@e@e@e@e@.w",
        "................................................................................",
        "..e@e@e@e@e@e@e@e@e@e@e@e.e@e@e@e@e@e@e@e@e@e@e@e@e@e@e@e@e@e@e@e@e@....@e@.....",
        "w..............................................................................w",
        "..e@e@e@e@e@e@e@e@e@e@e@e@e@e@e@e@e@ee@@e@@e@@e@@ee@@e@@e@@e@@e@@e@@e@@e@ee@@e..",
        "................................................................................",
        "w.e@e@e@e@e@e@e@e@e@e@e@e@e@e@e@e@e@e@..@e@e@e@e@e@e@e@e@e@e@e@e@e@e@e@e@e@@e@.w",
        "................................................................................",
        "..e@e@e@e@e@e@e@e@e@e@e@e@e@e@e@e@@e@e@@ee@e@e@e@e@e@e@e@e@e@e@e@e@e@e@e@e@@e@..",
        "w..............................................................................w",
        "..e@e@e@e@e@e@e@e.e@e@e@e@e@e@e@.e@.@ee@@e@e@e@e@e@e@e@e@e@e@e@e@e@e@e@e@e@e@...",
        "................................................................................",
        "w.e@e@e@e@e@e@e@e@e@e@e@e@e.@e@...e@@ee@ee@.@e@e@e@e.e@e@e@e@e@e@e@e@e@e@e@e...w",
        "................................................................................",
        "..e@e@e@e@e@e@e@e@e.e@e.e@e@e@e@e@e@e@e@ee@@e@e@e@@e@e@e@e@e@e@e@e@e@e@e@e@e@...",
        "w..............................................................................w",
        "..e@e@e@e@e@e@e......@e@e.e@e@e@e@e@e@e@e@e@e@.@ee@e@e@e@e@e@e@e@e@e@e@@e@@e@e..",
        "................................................................................",
        "w.e@e@e@e@e...........e@e@e@e@e@e@e@e@e@e@e@e@e@@e@e@e@e@e@e@e@e@e@e@e@e@e@ee@.w",
        "................................................................................",
        "..e@e@e.e@e.@e@...e@e@e@e@e@e@e@e@e@e@e@e@ee@@ee@e@e@e@e@e@e@e@e@e@e@e@e@e@ee@..",
        "w..............................................................................w",
        "..e@e@e@.......e@.e@e@e@e@e@e@e@e@e@e@e@e@e@e@@e@e@e@ee@@e@...e@@e@e@e@e@e@e@...",
        "................................................................................",
        "w.e@e@e...@e.@e@e@e@e@e.e@e@e@e@e@e@e@e@e@e@e@@e@e@e@@e@.e@e@@e@ee@e@e@e@e@ee@.w",
        "................................................................................",
        "..e@e@e@e@e.e@e@e@e@e@e@e@e@e@e@e@e@e@e@e@e@@e@e@.@e@....e@e@@e@e@..@e@e@e@e@...",
        "w..............................................................................w",
        "..e@e@e@e.e@e.e@e.e@e@e@e@e@e@e@e@e@e@e@e@ee@@e@@ee@e@@e@e@e@@e@e@e@..e@@e@ee@..",
        "................................................................................",
        "w.e@e@e.e@e.e@e@e@e@e@e@e.e@e@e@e@e@e@e@e@e@e@@e@@e@..@e@e@@e@e@e@e@e@e@.@e....w",
        "................................................................................",
        "..e@e@e@e@e@e@e@e@e@e@e@e@e@e@e@e@e@e@e@e.e@e@e@@e@e@.@ee@.@e@e@e@e@e@e@e@e@e...",
        "w..............................................................................w",
        "..e@e.e@e.e@e@e@e@e@e@e.e@e@e@e.e@e@e@e@e@e@e@ee@@ee@@e@e@e@e@e@e@e@e@e@e@e@e...",
        "................................................................................",
        "w.e@e@e@e@e@e@e@e@e@e@e@e@e@e@e@e@e@e@e@e@.e@@e@@e@e@e@@e@e@e@...........@e@e..w",
        "................................................................................",
        "..e@e.e@e@e@e@e.e@e@e@e.e@e@e@e@e@e@e@e@e@e.e@e@@e@e.e@@e@e@e@.e@e@@e.@e@e@e....",
        "w..............................................................................w",
        "..e@e@e@e@e@e@e@e@e@e@e@e@e@e@e@e@e@...@e@e@e@e@.@e@@e@e@@e@...e@e@e@e@e@e@.....",
        "................................................................................",
        "w.e@e@e........@e@.@e.e@e@..@e@@e@e@@e@..@e@e@e@e@e@e@e@.@e.@e@e@e@..@e@ee@@e..w",
        "................................................................................",
        "..e@e@ee@.......e@@ee@@e.@e@.@e@e@@e@e@e@e@@e@e@e@...@e@@e@e@e@e@e@@e@e@e@e.e@..",
        "w..............................................................................w",
        "..e@e@e@.e@e@e@e@e@e@e@e@e@e@e@e@e@e@@e@.@ee@e@e@@e.@e@e@e@e@e@e@@e@e@e@e@e@e@..",
        "................................................................................",
        "w.e@e@ee@@ee@e@e@e@e@e@e.e@e@e@e..@e.@e@e@@e@e@e@@e@@e@e@e@e@e@ee@.@e@e@e@e@e@.w",
        "................................................................................",
        "..e@e@e@e@..@e@e@e.e@e@e@e@e@e@e@..@e@e@..@e@e@@e@e@@e@@e@@e@e@e@e@@e@e@...@e@..",
        "w..............................................................................w",
        "..e@e@e@e@e@..@e.e@e@e@e@e.e@e@e@.e@e@e@@e@e@e@@e@e@...e@e@e@e@e@@e@.....@e@@e..",
        "................................................................................",
        "w.e@e@e@e.e@ee@e.e@e@e@e@e@e@e@@e@e@e@e@@e@e@e@e.e@e@e@e@e@e@e@e@e@@e@@e@e@ee@.w",
        "................................................................................",
        "..e@e@e.e@e@e@..@e@e.e@e@e@e@...e@e@e@@e@e@e@e@e@e@e@e@e@e@.e@@e@e@e@e@e@...e@..",
        "w..............................................................................w",
        "..e@e@e@e@e.e@e@e@@e@e@e@.....e@e@e@e@e@@e@.@ee@e@ee@e@e@e@e@e@e@e@e@e@...@ee@..",
        "................................................................................",
        "w.e@e@e@e@e@e@e@ee@@e@@ee@@ee@e@e@e@e@..@e@e@ee@e@e@@e.e@e@e@.@e@e@e@e@.e@e@e@.w",
        "................................................................................",
        "..e@e@e@e@e@e@e@e@e@e@ee@@e.e@e@e.e@e@e.e@e@e@e@e@e@e@e.e@@e@@e@e@..@e@e@e@.e@..",
        "w..............................................................................w",
        "..e@e@e@e.e@e@e@e@e@e@e@e@e@e.e@e@e.e@e@e@e@e@e@e@e@e@e@e@e@e@e@e@@e@e@@e@@ee@..",
        "................................................................................",
        "w.e@e@e@e@e@e.e@e@e@e@e@e@e@e@e.e@e@e@e@e@e@e@e@e@e@e@e@e@e@e@e@e@e@ee@@ee@ee@.w",
        "................................................................................",
        "..e@e@e@e@e@e@e@e@e.e@e@e@e@e@e@e.e@e@e@e@e@e@e@e@e@e@e@e.e@@e.e@@e@e@@e@e@e....",
        "w..............................................................................w",
        "..e@e.e@e@e.e@e@e@e.e@e@e@e@e@e@e@e@e@e@e@e@e@e.e@e@e@e@e@e@.e@@e@e@@e@e@e@e@...",
        "................................................................................",
        "w.e@e@e@e@e@e@e@e.e@e@e@e@e@e@e.e@e@e@e@e@e@e@e@e@e@e@e@e@e@@e.e@@e@e@@e@e@ee@.w",
        "................................................................................",
        "..e@e@e@e@e@e@e@e@e@e@e@e@e@e@e@e@e@e@e@e@e@e@e.e@e@e@e@e@.e@@e@e@e@@e@e@e@e@...",
        "w..............................................................................w",
        "..e@e@e@e@e@e.e@e@e@e@e@e@e@e@e@e@e@e@e@e@e@e@e@e@e@e@e@e@.e@.@ee@e@@e@e@..e@e..",
        "................................................................................",
        "w.e@e@e@e@e@e@e@e@e@e.e@e@e@e@e@e@e@e@e@e@e@e@e.e@e@e@e@e@@e@.e@e@e@e@@e@@e@@e.w",
        "................................................................................"
    ],
    "nca_runtime": 0.11031913757324219,
    "milp_runtime": 11.307114839553833,
    "nca_milp_runtime": 11.417433977127075,
    "sim_score": null,
    "weight": false,
    "n_row": 81,
    "n_col": 80,
    "n_endpoint": 1377,
    "n_agent_loc": 0,
    "n_shelf": 1400,
    "maxtime": 5000
}