{
    "name": "kiva_45x47_cma-mae_opt_entropy_throughput_hamming_a=0",
    "layout": [
        "..e@@e@@e@@e@@e@e@@e@@e@@e@@e@@e@@e@@e@@e@@e@..",
        "w.............................................w",
        "..e@@e...e@..@e@..@e@e@e..@e@@e@@e@.....@ee@e..",
        "..e............................................",
        "w.@@e.@.@...@.@@e.@@e@@@e.@.@.@.@.@e@.e@e.@.@.w",
        "..e.e.e.e.e.e.e.e.e.e.e.e.e.e.e.e.e.e.e.e.e.e..",
        "..e.@.@.@.@.@.@.@.@.@.@.@.@.@.@.@.@.@.@.@.@.@..",
        "w.@.e.e.e.e.e.e.e.e.e.e.e.e.e.e.e.e.e.e.e.e.e.w",
        "..e.@.@.@.@.@.@.@.@.@.@.@.@.@.@.@.@.@.@.@.@.@..",
        "..e.e.e.e.e.e.e.e.e.e.e.e.e.e.e.e.e.e.e.e.e.e..",
        "w.@.@.@.@.@.@.@.@.@.@.@.@.@.@.@.@.@.@.@.@.@.@.w",
        "..e.e.e.e.e.e.e.e.e.e.e.e.e.e.e.e.e.e.e.e.e.e..",
        "..e.@.@.@.@.@.@.@.@.@.@.@.@.@...@.@.@.@.@.@.@..",
        "w.@.e.e.e.e.e.e.e.e.e.e.e.e.e.e.e.e.e.e.e.e.e.w",
        "..e.@.@.@.@.@...@.@.@.@.@.@.@.@.@.@...@.@.@.@..",
        "..e.e.e.e.e.e.e.e.e.e.e.e.e.e.e.e.e.e.e.e.e.e..",
        "w.@.@.@.@.@.@.@.@.@.@.@.@.@.@.@.@.@.@.@.@.@.@.w",
        "..e.e.e.e.e.e.e.e.e.e.e.e.e.e.e.e.e.e.e.e.e....",
        "..e.@.@.@.@.@.@.@.@.@.@.@.@.@.@.@.@.@.@.@e@....",
        "w.@.e.e.e.e.e.e.e.e.e.e.e.e.e.e.e.e.e.e.e.e...w",
        "..e.e.e.e.e.e.e.e.e.e.e.e.e.e.e.e.e.e.e........",
        "..e.@.@.@.@.@.@.@.@.@.@.@.@.@.@.@.@.@.@.....@..",
        "w.@.e.e.e.e.e.e.e.e.e.e.e.e.e.e.e.e.e.e.e.e.e.w",
        "..e.e.e.e.e.e.e.@.@.@.@.@.@.@.@.@.@.@.@.@.@.@..",
        "..e.@.@.@.@.@.@.e.e.e.e.e.e.e.e.e.e.e.e.e.e.e..",
        "w.@.e.e.e.e.e.e.e.e.e.e.e.e.e.e.e.e.e.e.e.e.e.w",
        "..e.@.@.@.@.@.@.@.@.@.@.@.@.@.@.@.@.@.@.@.@.@..",
        "..e.e.e.e.e.e.e.e.e.e.e.e.e.e.e.e.e.e.e.e.e.e..",
        "w.@.@.@...@.@...@.@.@.@.@.@.@.@.@.@.@.@.@.@.@.w",
        "..e.e.e.e.e.e.e.e.e.e.e.e.e.e.e.e.e.e.e.e.e.e..",
        "..e.@.@.@.@.@.@.@.@.@.@.@.@.@.@.@.@.@.@.@.@.@..",
        "w.@.e.e.e.e.e.e.e.e.e.e.e.e.e.e.e.e.e.e.e.e.e.w",
        "..e.@.@.@.@...@.@.@.@.@.@.@.@.@.@.@.@.@.@.@.@..",
        "..e.e.e.e.e.e.e.e.e.e.e.e.e.e.e.e.e.e.e.e.e.e..",
        "w.@.@.@.@.@.@.@.@.@.@.@.@.@.@.@.@.@...@.@.@.@.w",
        "..e.e.e.e.e.e.e.e.e.e.e.e.e.e.e.e.e.e.e.e.e.e..",
        "................@.@.@.@.@.e.e..@e...@e@...@ee..",
        "w...................e.e.e.@.@e...@.@.@.@.@..@.w",
        "..e@e@e@@e@.@e@.@e@...e@e.e......e.e.e.e.e.....",
        "...e.e..............e@e....e...@e..@.@.@e@.....",
        "w.e.............e.e.@...e@e@..................w",
        "..@.@.@.@.@.@.@.@.@e@.@.@.@.e....@.@...e@.@....",
        "..e.e.e.e.e.e.e.e.e.e.e.e.e.@.@e.e.e.@e.e.e....",
        "w.............................................w",
        "..e@@e@e@@e@@e@@e@@e@@e@@e@@e@@e@@e@ee@ee@ee@.."
    ],
    "nca_runtime": 0.1023261547088623,
    "milp_runtime": 3.7985470294952393,
    "nca_milp_runtime": 3.9008731842041016,
    "sim_score": null,
    "weight": false,
    "n_row": 45,
    "n_col": 47,
    "n_endpoint": 486,
    "n_agent_loc": 0,
    "n_shelf": 440,
    "maxtime": 5000
}