{
    "name": "kiva_large_200_agents_dsage-nca_opt_entropy_throughput_hamming_a=5",
    "layout": [
        "..e@..@e@@e@e@e@ee@@e@@e@@e@@@@@e@..",
        "w.e......e..................eee..e.w",
        "..@@ee@ee@@ee@@ee@e@@ee@@e.e@@@e@e..",
        "......e.............................",
        "w...e@.e@e.e@@e.e@e@ee@@e.e@e@e@@e.w",
        "....................................",
        "..e@e..@ee@ee@ee@@eee@@e.e@e@ee@@e..",
        "w..................@...............w",
        "....e@.e@@e.e@e@e@ee@e@ee@@e@ee@@e..",
        "....................................",
        "w.e@e.e@e.e@@e@e@ee@.@e@e@@e@ee@@e.w",
        ".................................e..",
        "...e@.@e.e@e@ee@ee@.@ee@e@e@@ee@e@..",
        "w.........................e......e.w",
        "...e@@e.e@e@ee@ee@.@ee@e.e@@e.e@@e..",
        ".................................e..",
        "w..e@@e.e@@ee@@ee@@ee@@ee@@e.e@ee@.w",
        ".................................e..",
        "...e@@ee@e@ee@@ee@@ee@@ee@@ee@e@ee..",
        "w................................@.w",
        "...e@@ee@@e.e@@ee@@ee@@ee@@ee@@e.e..",
        ".................................e..",
        "w..e@@ee@@ee@@ee@@ee@@ee@@e.e@@ee@.w",
        "................................ee..",
        "...e@@ee@@ee@@ee@@ee@@ee@@ee@@ee@e..",
        "w................................e.w",
        "..e@e@ee@@e.e@..@e.e@@ee@@e.e@@ee@..",
        ".................................e..",
        "w...@e.e@@ee@..@e.e@ee@ee@@ee@@ee@.w",
        "....................................",
        "..e@@ee@@ee@..@e.e@@e@@ee@@ee@@ee@..",
        "w..................................w",
        "..e@@ee@@ee@.@e.e@@ee@@ee@@ee@e@@e.."
    ],
    "nca_runtime": null,
    "milp_runtime": null,
    "nca_milp_runtime": null,
    "sim_score": null,
    "weight": false,
    "n_row": 33,
    "n_col": 36,
    "n_endpoint": 269,
    "n_agent_loc": 0,
    "n_shelf": 240,
    "maxtime": 5000
}