{
    "name": "kiva_xxlarge_cma-mae_global_opt_repaired_one_endpt_uneven_w_iter=200",
    "layout": [
        "...e.e.e.@e@@e@@e@@e@@e@@e@@e@@e@@e@@e@@e@@e@@e@@e@@e@.@e@@e@@e@@e@@e@@e@@e@@e@@e@@e@@e@@e@@e@@e@@e@..",
        "w..@.@.@.............................................................................................w",
        "...e.e.e...........................................................................................e..",
        "...e.e.e.@e@@e@@e@@e@@e@@e@@e@@e@@e@@e@@e@@e@@e@@e@@e@@e@@e@@e@@e@@e@@e@@e@@e@@e@@e@@e@@e@@e@@e@@e@@..",
        "w..@.@.@.............................................................................................w",
        "...e.e.e.e@@.......................................................................................e..",
        "...e.e.e.e.e.@e@@e@@e@@e@e@@e@@e@@e@@e@@e@@e@@e@@e@@e@@e@@e@@e@@e@@e@@e@@e@@e@@e@@e@@e@@e@@e@@e@@e@@..",
        "w..@.@.@.@.e.........................................................................................w",
        "...e.e.e.e.@.e@@...................................................................................e..",
        "...e.e.e.e.e.e.e.@e@@e@@e@@e@@e@@e@.@e@@e@@e@@e@@e@@e@@e@@e@@e@@e@@e@@e@@e@@e@@e@@e@@e@@e@@e@@e@@e@@..",
        "w..@.@.@.@.e.@.e.....................................................................................w",
        "...e.e.e.e.@.e.@.e@@...............................................................................e..",
        "...e.e.e.e.e.e.e.e.e.@e@@e@@e@@e@@e@@e@@e@@e@@e@@e@@e@@e@@e@@e@@e@@e@@e@@e@@e@@e@@e@@e@@e@@e@@e@@e@@..",
        "w..@.@.@.@.e.@.e.@.e.................................................................................w",
        "...e.e.e.e.@.e.@.e.@.e@@...........................................................................e..",
        "...e.e.e.e.e.e.e.e.e.e.e.@e@@e@@e@@e@@e@@e@e@@e@@e@@e@@e@@e@@e@@e@@e@@e@@e@@e@@e@@e@@e@@e@@e@@e@@e@@..",
        "w..@.@.@.@.e.@.e.@.e.@.e.............................................................................w",
        "...e.e.e.e.@.e.@.e.@.e.@.e@@.......................................................................e..",
        "...e.e.e.e.e.e.e.e.e...e.e.e.@e@@e@@ee@@e@@e@@e@@e@@e@@e@@e@@e@@e@@e@@e@@e@@e@@e@@e@@e@@e@@e@@e@@e@@..",
        "w..@.@.@.@.e.@.e.@.e.e.e.@.e.........................................................................w",
        "...e.e.e.e.@.e.@.e.@.@.@.e.@.e@@...................................................................e..",
        "...e.e.e.e.e.e.e.e.e.e.e.e.e.@.e..@e@@e@@e@@e@@e@@e@@e@@e@@e@@e@@e@@e@@e@@e@@e@@e@@e@@e@@e@@e@@e@@e@..",
        "w..@.@.@.@.e.@.e.@.e.e.e.@.e.e.e.....................................................................w",
        "...e.e.e.e.@.e.@.e.@.@.@.e.@.e.@.e@@...............................................................e..",
        "...e.e.e.e.e.e.e.e.e.e.e.e.e.@.e.e.e.@e@@e@@e@@e@@e@@e@@e@@e@@e@e@@e@@e@@e@@e@@e@@e@@e@@e@@e@@e@@e@@..",
        "w..@.@.@.@.e.@.e.@.e.e.e.@.e.e.e.@.e.................................................................w",
        "...e.e.e.e.@.e.@.e.@.@.@.e.@.e.@.e.@.e@@...........................................................e..",
        "...e.e.e.e.e.e.e.e.e.e.e.e.e.@.e.e.e.e.e.e@@e@@e@@e@e@@e@@e@@e@@e@@e@@e@@e@@e@@e@@e@@e@@e@@e@@e@@e@@..",
        "w..@.@.@.@.e.@.e.@.e.e.e.@.e.e.e.@.e.@.e.............................................................w",
        "...e.e.e.e.@.e.@.e.@.@.@.e.@.e.@.e.@.e.@.e@@.......................................................e..",
        "...e.e.e.e.e.e.e.@.e.e.e.e.e.@.e.e.e.e.e.e.e.@e@@e@@e@@e@@e@@e@@e@@e@@e@@e@@e@@e@@e@@e@@e@@e@@e@@e@@..",
        "w..@.@.@.@.e.@.e.e.e.e.e.@.e.e.e.@.e.@.e.@.e.........................................................w",
        "...e.e.e.e.@.e.@.e.@.@.@.e.@.e.@.e.@.e.@.e.@.e.e@@e@@e@@e@@e@@e@@e@@e@@e@@e@@e@@e@@e@@e@@e@@e@@e@@e@..",
        "...e.e.e.e.e.e.e.@.e.e.e.e.e.@.e.e.e.e.e.e.e.@.e......................................................",
        "w..@.@.@.@.e.@.e.e.e.e.e.@.e.e.e.@.e.@.e.@.@.e.@.e.@@e@@e@@e@@e@@e@@e@@e@@e@@e@@e@@e@@e@@e@@e@@e@@e@.w",
        "...e.e.e.e.@.e.@.e.@.@.@.e.@.e.@.e.@.e.@.e.e.e.e.@.e..................................................",
        "...e.e.e.e.e.e.e.@.e.e.e.e.e.@.e.e.e.e.e.e.e.@.e.e.@...............................................e..",
        "w..@.@.@.@.e.@.e.e.e.e.e.@.e.e.e.@.e.@.e.@.@.e.@.e.e.e@@e@@e@@e@@e@@e@@e@e@@e@@e@@e@@e@@e@@e@@e@@e@@.w",
        "...e.e.e.e.@.e.@.e.@.@.@.e.@.e.@.e.@.e.@.e.e.e.e.@....................................................",
        "...e.e.e.e.e.e.e.@.e.e.e.e.e.@.e.e.e.e.e.@.e.@.e.e.@e@@e@@e@@e@@e@@e@@e@@e@@e@@e@@e@e@@e@e@@e@@e@@e@..",
        "w..@.@.@.@.e.@.e.e.e.e.e.@.e.e.e.@.e.@.e.e.@.e.@.....................................................w",
        "...e.e.e.e.@.e.@.e.@.@.@.e.@.e.@.e.@.e.@.e.e.e.e.@e@@e@@e@@e@@e@@e@@e@@e@@e@@e@@e@@e@@e@@e@@e@@e@@e@..",
        "...e.e.e.e.e.e.e.@.e.e.e.e.e.@.e.e.e.e.e.@.e.@.@......................................................",
        "w..@.@.@.@.e.@.e.e.e.e.e.@.e.e.e.@.e.@.e.e.@.e.e..@e@@e@@e@@e@@e@@e@@e@@e@e@@e@@e@@e@@e@@e@@e@@e@@e@.w",
        "...e.e.e.e.@.e.@.e.@.@.@.e.@.e.@.e.@.e.@.e.e.e.e......................................................",
        "...e.e.e.e.e.e.e.@.e.e.e.e.e.@.e.e.e.e.e.@.e.@.@.e.e@@e@@e@@e@@e@@e@@e@@e@@e@e@@e@@e@@e@@e@@e@@e@@e@..",
        "w..@.@.@.@.e.@.e.e.e.e.e.@.e.e.e.@.e.@.e.e.@.e.e.@.e.................................................w",
        "...e.e.e.e.@.e.@.e.@.@.@.e.@.e.@.e.@.e.@.e.e.e.e.e.@.e@@e@@e@@e@@e@@e@@e@@e@@e@@e@@e@@ee@@e@@e@e@@e@..",
        "...e.e.e.e.e.e.e.@.e.e.e.e.e.@.e.e.e.e.e.@.e.@.@.e.e.e................................................",
        "w..@.@.@.@.e.@.e.e.e.e.e.@.e.e.@.@.e.@.e.e.@.e.e.@.e.@.@e@@e@@e@@e@@e@@e@@e@@e@@e@@e@@e@@e@@e@@e@@e@.w",
        "...e.e.e.e.@.e.@.e.@.@.@.e.@.e.e.e.@.e.@.e.e.e.e.e.@..................................................",
        "...e.e.e.e.e.e.e.@.e.e.e.e.e.@.e.e.e.e.e.@.e.@.@.e.e.e@@e@@e@@e@@e@@e@@e@@e@@e@@e@@e@@e@@e@@e@@e@@e@..",
        "w..@.@.@.@.e.@.e.e.e.e.e.@.e.e.@.@.e.@.e.e.@.e.e.@...................................................w",
        "...e.e.e.e.@.e.@.e.@.@.@.e.@.e.e.e.@.e.@.e.e.e.e.e.@e@@e@@e@@e@@e@.@e@@e@@e@@e@@e@@e@@e@@e@@e@@e@@e@..",
        ".....e.e.e.e.e.e.@.e.e.e.e.e.@.e.e.e.e.e.@.e.@.@......................................................",
        "w..e.@.@.@.e.@.e.e.e.e.e.@.e.e.@.@.e.@.e.e.@.e.e.@e@@e@@e@@e@@e@@e@@e@@e@@e@@e@@e@@e@@e@@e@@e@@e@@e@.w",
        "...@.e.e.e.@.e.@.e.@.@.@.e.@.e.e.e.@.e.@.e.e.e........................................................",
        "...e.@.e.e.e.e.e.@.e.e.e.e.e.@.e.e.e.e.e.@.e.@.@e@e@@e@@e@@e@@e@@e@@e@@e@@e@@e@@e@@e@@e@@e@@e@@e@@e@..",
        "w..e.e.@.@.e.@.e.e.e.e.e.@.e.e.@.@.e.@.e.e.@.........................................................w",
        "...@.e.e.e.@.e.@.e.@.@.@.e.@.e.e.e.@.e.@.e.e.@e@@e@@e@@e@@e@@e@@e@@e@@e@@ee@@e@@e@@e@@e@@e@@e@@e@@e@..",
        "...e.@.e.e.e.e.e.@.e.e.e.e.e.@.e.e.e.e.e.@............................................................",
        "w..e.e.@.@.e.@.e.e.e.e.e.@.e.e.@.@.e.@.e.e.@e@@ee@@e@@e@@e@@e@@e@@e@@e@@e@@e@@e@@e@@e@@e@@e@@e@@e@@e.w",
        "...@.e.e.e.@.e.@.e.@.@.@.e.@.e.e.e.@.e.@..............................................................",
        "...e.@.e.e.e.e.e.@.e.e.e.e.e.@.e.e.e.e.e.@e@@e@@e@@e@@e@@e@@e@@e@@e@@e@@e@@e@@e@@e@@e@@e@@e@@e@@e@@e..",
        "w..e.e.@.@.e.@.e.e.e.e.e.@.e.e.@.@.e.@...............................................................w",
        "...@.e.e.e.@.e.@.e.@.@.@.e.@.e.e.e.@.e.@e@e@@e@@e@@e@e@@e@e@@e@e@@e@@e@@e@@e@@e@@e@@e@@e@@e@@e@@e@@e..",
        "...e.@.e.e.e.e.e.@.e.e.e.e.e.@.e.e.e..................................................................",
        "w..e.e.@.@.e.@.e.e.e.e.e.@.e.e.@.@...@e@@e@@e@@e@@e@@e@@e@@e@@e@@e@@e@@e@@e@@e@@e@@e@e@@e@@e@e@@e@@e.w",
        "...@.e.e.e.@.e.@.e.@.@.@.e.@.e.e.e....................................................................",
        "...e.@.e.e.e.e.e.@.e.e.e.e.e.@.e...@e@@e@@e@@e@@e@@e@@e@@e@@e@@e@@e@@e@e@@e@@e@@e@@e@@e@@e@@e@@e@@e@..",
        "w..e.e.@.@.e.@.e.e.e.e.e.@.e.e.@.....................................................................w",
        "...@.e.e.e.@.e.@.e.@.@.@.e.@.e.e.@e@@e@@e@@e@@e@@e@@e@@e@@e@@e@@e@@e@@e@@e@e@@e@@e@@e@e@@e@@e@@e@@e@..",
        "...e.@.e...e.e.e.@.e.e.e.e.e.@........................................................................",
        "w..e.e.@.e.e.@.e.e.e.e.e.@.e.e.@e@@e@@e@@e@@e@@e@@e@@e@@e@@e@@e@@e@@e@@e@@e@@e@@e@@e@@e@@e@@e@@e@@e@.w",
        "...@.e.e.@.@.e.@.e.@.@.@.e.@..........................................................................",
        "...e.@.e.e.e.e.e.@.e.e.e.e.e.@e@@e@@e@@e@@e@@e@@e@@e@e@@e@@e@@e@@e@@e@@e@@e@@e@@e@@e@@e@@e@@e@@e@@e@..",
        "w..e.e.@.e.e.@.e.e.e.e...@...........................................................................w",
        "...@.e.e.@.@.e.@.e.@.@.e.e.@e@@e@@e@@e@@e@@e@@e@@e@@e@@e@@e@@e@@e@@e@@e@@e@@e@@ee@@e@@e@@e@@e@@e@@e@..",
        "...e.@.e.e.e.e.e.@.e.e.@..............................................................................",
        "w..e.e.@.e.e.@.e.e.e.e.e.@e@@e@@e@@e@@e@@e@@e@@e@@e@@e@@e@@e@@e@@e@@e@@e@@e@@e@@e@@e@@e@@e@@e@@e@@e@.w",
        "...@.e.e.@.@.e.@.e.@.@................................................................................",
        "...e.@.e.e.e.e.e.@.e.e.@e@@e@@e@@e@@e@@e@@e@@e@@e@@e@@e@@e@@e@@e@@e@@e@@e@@e@@e@@e@@e@@e@@e@@e@@e@@e..",
        "w..e.e.@.e.e.@.e.e.e.................................................................................w",
        "...@.e.e.@.@.e.@.e.@.@e@@e@e@@e@@e@@e@@e@@e@@e@e@@e@@e@@e@@e@@e@@e@@e@@e@@ee@@e@@e@@e@@e@@e@@e@@e@@e..",
        "...e.@.e.e.e.e.e.@....................................................................................",
        "w..e.e.@.e.e.@.e.e.@e@@e@@e@@e@@e@@e@@e@@e@@e@@e@@e@@e@@e@@e@@e@@e@@e@@e@@e@@e@@e@@e@@e@@e@@e@@e@@e@.w",
        "...@.e.e.@.@.e.@......................................................................................",
        "...e.@.e.e.e.e.e.@e@@e@@e@@e@@e@@e@@e@@e@@e@@e@e@@e@@e@@e@@e@@e@@e@@e@@e@@e@@e@@e@@e@@e@@e@@e@@e@@e@..",
        "w..e.e.@.e.e.@.......................................................................................w",
        "...@.e.e.@.@.e.@e@@e@@e@@e@@e@e@@e@@e@@e@@e@@e@@e@@e@@e@@e@@e@@e@@e@@e@@e@@e@@e@@e@@e@e@@e@@e@@e@@e@..",
        "...e.@.e.e.e..........................................................................................",
        "w..e.e.@.e...@e@@e@@e@@e@@e@@e@@e@@e@@e@@e@@e@@e@@e@@e@@e@@e@@e@@e@@e@@e@@e@@e@@e@@e@@e@@e@@e@@e@@e@.w",
        "...@.e.e.@............................................................................................",
        "...e.@.e.e.@e@@e@@e@@e@@e@@e@@e@@e@@e@@e@@e@@e@@e@@e@@e@@e@@e@@e@@e@@e@@e@@e@@e@@e@@e@@e@@e@@e@@e@@e..",
        "w..e.e.@.............................................................................................w",
        "...@.e.e.@e@@e@@e@@e@@e@@e@@e@@e@@e@@e@@e@@e@@e@@e@@e@@e@@e@@e@@e@@e@@e@e@@e@@e@@e@e@@e@@e@@e@@e@@e@..",
        "...e.@................................................................................................",
        "w..e.e.@e@@e@@e@@e@@e@@e@@e@@e@@e@@e@@e@@e@@e@@e@@e@@e@@e@@e@@e@@e@@e@@e@@e@@e@@e@@e@@e@@e@@e@@e@@e@.w",
        "...@..................................................................................................",
        "...e.e@@e@@e@@e@@e@@e@@e@@e@@e@@e@@e@@e@@e@@e@@e@@e@@e@@e@@e@@e@@e@@e@@e@@e@@e@@e@@e@@e@@e@@e@@e@@e@..",
        "......................................................................................................"
    ],
    "nca_runtime": null,
    "milp_runtime": null,
    "nca_milp_runtime": null,
    "weight": false,
    "n_row": 101,
    "n_col": 102,
    "n_endpoint": 1994,
    "n_agent_loc": 0,
    "maxtime": 5000
}