{
    "name": "kiva_xxlarge_cma-mae_global_opt_repaired_iter=200",
    "weight": false,
    "n_row": 101,
    "n_col": 102,
    "n_endpoint": 40,
    "n_agent_loc": 40,
    "maxtime": 5000,
    "layout": [
        "......................................................................................................",
        "w.@ee@...............e@@ee@.........e@@e@e@@e.....e@.......................@e.e@..@e@@e@.e@@e@@e@@e@.w",
        "......................................................................................................",
        "..@e@@ee@...@e@.e@@e@e@@e.@e@@e@.e@@e@@e@@ee@@e@@e.@e............e@@e....e@@e@@e@@e@@ee@@e@@e@@e.@e@..",
        "w....................................................................................................w",
        "..@e.e@..e@@e...e@.e@.@e@..e@@e..@e@@e@@e@e@@e@e@@ee@@e@e...e@@e@.@e@e@e@@e@@e@@e@e@e@@e@@ee@@e@@ee@..",
        "......................................................................................................",
        "w.@e@.......@ee@.e@..e@.........@ee@@e..e@@e@e@@e@......@ee@@ee@@e.e@@e@@e@.@e@@e@@e@e@e@@e@@ee@@ee@.w",
        "......................................................................................................",
        "..@e@@ee@@e@@e@@e@.@e@@e@ee@@e@..e@e@@e..e@@e@...e@....@e@.e@.@e.@ee@@e@@e@@e.e@@e@@e@@e...@e@@e@@e@..",
        "w....................................................................................................w",
        "..e@e@...@e@@e@...@e@ee@..@e@......e@...e@....@e.e@@e@e@e@@e@@e.e@.@e@@e@...@e@@e@@e@.@e@@e@@e@e@@e@..",
        "......................................................................................................",
        "w.e@@e..e@..@e@@e@@e.@e..e@.e@@e.@e@@e..e@.e@@e@@e...@ee@@e...@e.@e@@e@@e@@e@@e@e@@e@@e@@e@.@e@@e@e@.w",
        "......................................................................................................",
        "..@e....e@@e.......@e..e@@e@@e@@ee@@e@..@e@@ee@@e@@e@...e@@e@@ee@@e@e@@e@@e@e@@ee@@e...@e@@e@@e@@e@...",
        "w....................................................................................................w",
        "..@e.....@ee@..@e@.@e@@e@e@@e@..e@@e..@e...@ee@@ee@@e.e@@e..e@@e@@e@e@@e@@ee@@e@e@@e.@e@@e@@e@@e@@e@..",
        "......................................................................................................",
        "w.@ee@@e.@e@@e@e.....e@...@e@@e.@e@..@e@@e@...e@@e@@ee@@ee@@e@@e@e@@e@@e@@ee@@e.@e@@e@@e@@e@@e@@e@@e.w",
        "......................................................................................................",
        "..@e..@e@e@.@e@e@e@.@ee@.@e@.e@@e@@e.@e@ee@.....@e@@e.e@@ee@@e@.@e@e@@e@@e@@e@@e@.e@@ee@@e@@e@@e@@e@..",
        "w....................................................................................................w",
        "..@e@@e...@ee@@e@.........@e@e@...e@.....@e@..e@@ee@@e.e@..e@@e@@e@.@e@.e@@e@e@..e@@ee@@e@@e@@ee@@e@..",
        "......................................................................................................",
        "w.@e@.@e@@e@@e......@e...@e@.@e@.@e.e@@e..e@@e..@e@@e@@e...@e@@e@@e@.@e@@e@.@e@.@e...@e@@e@@e@@e@@e@.w",
        "......................................................................................................",
        "..@e@e@..e@@e@..e@.@ee@@e@...@e@e.@e..@e@...@e@e@@ee@@e.e@@e@e@@e@@e..e@@e@....e@.@e@.@e@@e@@e@e@@e@..",
        "w....................................................................................................w",
        "..@e@.e@@e@e@@e@@e.@e.@ee@@e@@e.@e@.@e@e@@e@@e@e@@ee@@e@@e.e@@e@@e@@e@e@@e@@e@@ee@@e@@e@@e@@e@@e@@e@..",
        "......................................................................................................",
        "w.e@..@e...e@@e.@e.@e@@e@e@.e@......e@@e.e@@e@@e@@e@e@@e...e@.e@@e@e@@e@..@e@@e@e@.e@@e@@e@e@@e@@e@..w",
        "......................................................................................................",
        "..e@@ee@.@ee@@e@e@.e@@e@@e...e@...@e@@ee@.@ee@@e..@e@@e..e@@e@e@@e@e@e@@e@e@...@ee@.e@@e@@e@@e@@e@@e..",
        "w....................................................................................................w",
        "..@e.e@@e@...@e@@e.@e@e@@ee@@e.e@@e@e@.e@@e@@e@@e@@e@..@e..@e@.@e@@e@@e.@e...@e@@ee@@e@@e@@ee@@e@@e@..",
        "......................................................................................................",
        "w.@e.@ee@...@e..e@@ee@@ee@@e.e@@e@@e@e@@e.e@@e@@e.e@@e@@e@..e@@e@@ee@@e@@e@@e@@e@@ee@@e@@e@@e@@e@@e@.w",
        "......................................................................................................",
        "..e@@ee@@e@..@e@.e@@e@@e@@e@@e..e@.@e@@e@@ee@@e@..@e@@e@@e@@e@@e@.e@@e@@e@@e@@e@@e..@e@@e@@e@e@@e@@e..",
        "w....................................................................................................w",
        "..@e@e@.e@@e@e@..e@@e@.e@@ee@@e.@e.@e@@ee@@e@@e@@e@e@@e@@ee@@e@@e@e@@e@@e@@e@e@@e@@e.e@.@e@@e@@e@@e@..",
        "......................................................................................................",
        "w..@e.@e@.e@..e@...@e@@e@@e@.@e.e@@e@@e@e@@e@@e@.@e@@e@@e@@e@@ee@@e@@e..@e@@e@e@.@e@@e@e@@e@@e@@e@@e.w",
        "......................................................................................................",
        "..@e...@e@.@e@.e@@e@..@e@@e@@ee@@e@e@@ee@@e@@e@@ee@@e@@e@@e@@ee@.@e@.@e@@e@@e@@e@@e@.@e@@e@@e@@e@@e@..",
        "w....................................................................................................w",
        "..@e...e@.e@@ee@@e@e@@e.@e...e@.@e@@e.@e@@e@@e@@e@@e@@e@@e@@e@@e@e@@e@@e@@e@@e@@e@@e..@e@@e@@e@@e@@e..",
        "......................................................................................................",
        "w.@e@.@e..e@@ee@@e..@e@@e@.@e@@e@@e@@ee@@ee@@e@@e@@e@@e@@e@.@e@@e.@e@e@@e@.e@@e@@e@@e@e@@e@@e@@e@@e@.w",
        "......................................................................................................",
        "..e@..@e@@ee@@ee@@e@@e.e@@ee@@e@e@.@e@@e@@ee@@e@@e@e@@e@@ee@@e@@e@@e@@e@@e@e@@ee@@ee@@e@e@@e@@e@@e@...",
        "w....................................................................................................w",
        "..e@@e@..e@....@e@@e@e@@e@@e@e@@e@@e@.e@.e@@e@@e.e@@e@@e@@e@@e@@e@@e@@e@@e@.@e@@e@@e@@e@@e@e@@e@@e@...",
        "......................................................................................................",
        "w.@e@e@@e@.@e@@e@.e@@ee@@e@@e@@e@@e@@e@@ee@@e@@ee@@e@@e@@e@@e@@e@@e@@e@@e@@ee@@e@@e@@e@@e@.@e@@e@@e@.w",
        "......................................................................................................",
        "..@e.@e...@e.@e@@e.e@..@e.e@@e@e@@e@@e@@e@@e...@e@@e@@e@@e@@e@@e@@e@@e@@e@@e@.@e@e@@e@@e@e@@e@@e@@e@..",
        "w....................................................................................................w",
        "..e@@ee@@e@@e@e@@e@@e@@e@@e@.e@@e@@e@@e@@e@@ee@@e...e@@e@@e@@e@@e@@e@@ee@@e@@e@@e@@e@@e@@e@@e@@e@@e@..",
        "......................................................................................................",
        "w.@e@@ee@@e.@e..@e@e@@e@@e@@e@@e@@e.@e..e@@e@@e@@e@@e@@e@.@e@@e....@e@@e@.@e@e@@e@@e@@e@@e@@e@@e@@e@.w",
        "......................................................................................................",
        "..@e...@ee@@e@.@e..@e@@ee@.@e@@e@e@@e..@ee@@e@..e@@e@e@.@e@@e@@e..e@...e@@e@e@@e@@e@@e@@e@@e@@e@e@@e..",
        "w....................................................................................................w",
        "..@e@@e@@e@@e@.e@.@e@e@@e@@e@@e@....e@@e@.e@@ee@@e@e@ee@@e@@e@@e.e@@e@e@e@@e@.@ee@@ee@@e@@e@@e@@e@@e..",
        "......................................................................................................",
        "w.@e@e@.@e@e@@e@@e..@e@@e@@e@..e@.e@@e..e@@e@@e@..e@@e...@e@e@@e.@e@@ee@@e.e@@e@@e.@e@@ee@@e@@e@@e@e.w",
        "......................................................................................................",
        "..@e@@e@.@e@@ee@@e@@e@@e@...e@...e@@e.e@@e@.e@@e@@e@@e@.@e@@e@@e@@e@e@@ee@.e@@e@.e@@ee@@e@@ee@@e@@e@..",
        "w....................................................................................................w",
        "..e@.@e@@e@e@@e@@ee@@e@e@.e@.@e@@e@@e@@e@e@.e@.@e..@e@@e@@e@e@@e@@e@@e@@e@@e@@e@@e@e@e@@e@e@@e@@e@@e..",
        "......................................................................................................",
        "w.@e..@e.@e@..@e@e@.@e@..e@.e@@ee@@e@.@e@@e@.@e@@e@@e@@e@@e@e@.@e@@e@@e@e@@e@@e@.@e@.@e@@e@@e@@e@@e@.w",
        "......................................................................................................",
        "..@e....e@@e@.@e.....e@@e..@e@@e..@e@@e@.@e@..@e@@e@@e.@e@@e@.@e@@e@e@@ee@@e@@e@@e.e@..e@@e@@e@@e@@e..",
        "w....................................................................................................w",
        "..@e.@e@@ee@@e.e@@e..@e...e@@e@@e@e@..@ee@@e@@ee@@e@e@@e@@e....e@@e...@e@ee@@e@..e@@e@@e@@e@@e@@e@@e..",
        "......................................................................................................",
        "w.@e@@e..@e@@e@@e@.@e@e@@e@@e@@e@@e@@e@@e.e@@e@@ee@@e@@ee@@ee@@e@@e@@e@.@e@@e@@ee@@e@@e@@ee@@e@@e@@e.w",
        "......................................................................................................",
        "..@e...@e@@ee@@e@....e@@e@.e@.@e@@ee@@e.@ee@@e.e@@e@...@e@@ee@@e@e@@e@@e@@e@e@..e@@e@@e@e@@e@@e@@e@...",
        "w....................................................................................................w",
        "..e@.@ee@@e@@e@..@e@@e@@e@@e@@e@@e@@e@e@@e@.@e@@e@.@e@@ee@@e@@e@e@e@@e@@e@e@@e@@e@@e@e@@ee@@e@@e@@e@..",
        "......................................................................................................",
        "w.@e..@e@.@e@ee@@e@@e@@e.@e@@e..e@@e@@e@e@@e@@e@e@e@@e@@e@@ee@@e.e@@e@.@e@@ee@@e@@e@@e@.@e@@e@@e@@e@.w",
        "......................................................................................................",
        "..@e@e.@e@@ee@e@@e@e@.e@..e@@e@@ee@.@ee@@e@e@@e@@e@@e@e@@e@e@@e@@ee@e@@e@@e..@e@e@@e@@e@@e@@e@@e@@e@..",
        "w....................................................................................................w",
        "...@e@@e@.@e@e@..@e@@e@@ee@@e@.@ee@@e@e@@e@..@e@@e@e@@e@@e@@e@@e@@ee@@e@e@@e@e@@e@@e@@e@@e@@e@@e@@e@..",
        "......................................................................................................",
        "w.e@@e@e@e@.e@@e@@e@ee@.@e@..e@...@e.@e@@e...e@@e@@e@e@@e@@e@@e@@e@.e@@ee@@e@@e.e@@e@@e@@e@@e@@e@@e@.w",
        "......................................................................................................",
        "..@e.....@e@@e@....@e@...e@@e.e@e@@e@.e@@e@e@@e@e@@e@@e@@e@@e@@ee@@e@@ee@@e@@e@@e@@e@e@@e@e@@e@@e@@e..",
        "w....................................................................................................w",
        "..e@.e@@e@@ee@@e@@e@@e@@e@..@e.e@@e@@e@@e@e@e@@e@@e@@ee@e@@ee@@e@@e@.@e@@e@.@e@e@@e@..e@@e@e@@e@@ee@..",
        "......................................................................................................",
        "w.@e@.@e@.@e..@ee@@ee@@e@.@e@.@e@..e@@e@.e@@e@..e@@e@@e@@e@e@@e@....e@@e.@e@@e@@e@@e@@e@@e@@e@@e@@e@.w",
        "......................................................................................................",
        "..e@@e..@ee@@ee@.@e@e@...e@@e..e@@e.@e@..e@@e@@e@@e@@e@..@e@@e@@ee@@e@@ee@@e@@e@@e@e@@e@@e@@e@@e@@e@..",
        "......................................................................................................"
    ]
}