{
    "name": "kiva_xxlarge_cma-mae_global_opt_repaired_one_endpt_throughput-hamming_a=1_iter=200",
    "layout": [
        ".................e.@e@e@e@e@ee@ee@@e@e@e@.e@e@e@eee@e@ee@e@e@@e.e@e@e@e@e@e@e@ee@ee...................",
        "w.@@e@@e@@@e@@@e@@@..............................@................................@@e@@e@@e@@@@@e@@e.w",
        "..e......e...e....ee@ee@ee@ee@ee@ee@ee@ee@ee@ee@eee@ee@ee@ee@ee@e@ee@ee@ee@ee@ee@ee.........eee.......",
        "..@@e@@e@@@e@@@@e@@...................................................................@e@@e@@@@@e@@@..",
        "w.............e....ee@ee@ee@ee@ee@ee@ee@ee@ee@ee@ee@ee@ee@ee@ee@ee@ee@ee@ee@ee@ee@ee@e............ee.w",
        "..@@@e@@@e@@e@@@@e@@..................................................................@.@e@@@@e@@e@@..",
        "..ee...e.......e....e@ee@ee@ee@ee@ee@ee@ee@ee@ee@ee@ee@ee@ee@ee@ee@ee@ee@ee@ee@ee@ee@eee@e.ee.........",
        "w.@@@e@@@e@@@e@@@e@@e@........................................................................@.@@e..w",
        "...........e........e.e@ee@ee@ee@ee@ee@ee@ee@ee@ee@ee@ee@ee@ee@ee@ee@ee@ee@ee@ee@ee@ee@ee@ee@eeee.....",
        "..@@@e@@e@@@@@e@@@e@@@.........................................................................@e.ee..",
        "w.ee......e.e...e....ee@ee@ee@ee@ee@ee@ee@ee@ee@ee@e@ee@@e@@e@@e@@e@@e@@e@@e@@e@@e@@e@@e@@e@@e@@e@@@.w",
        "..@@@e@@e@@@@@e@@@@e@@@......................@........................................................",
        "...........e.....e......e@ee@ee@ee@ee@ee@ee@eee@ee@ee@ee@ee@ee@ee@ee@ee@ee@ee@ee@eeeeeeeee@ee@e@ee@e..",
        "w.@e@@e@@@@@@e@@@@@@@e@@..........................................................@@@@@@@............w",
        "........eee....ee.ee...eeee@ee@ee@ee@ee@ee@ee@ee@ee@ee@ee@ee@ee@ee@ee@ee@ee@eeeeeee....eeeeeeee.ee@e..",
        "..@@@e@@@@@@e@@@@@@@@e@@@@...................................................@@@@@@@e@@@@@@@@@@@@@....",
        "w.ee...e......e..e......eee@ee@ee@ee@ee@ee@ee@e@ee@ee@ee@ee@ee@ee@eeeeeeeee...........e........e.....w",
        "..@@@e@@@e@@e@@@@@@@@e@@......................................@....@@@@@@@@@e@@e@@e@@@@@@e@@@e@@@e@...",
        "...............ee.ee...e.e@ee@ee@ee@ee@ee@ee@ee@ee@ee@ee@ee@eeeee@..................ee.e...e..........",
        "w.@@e@@@@@@e@@@@@@@@@e@@.....................................@.@.@@@e@@@@e@@e@@e@@e@@@@@@e@@@@e@@e@..w",
        "..e...eeee...ee..e......ee@ee@ee@ee@ee@e@ee@ee@ee@ee@ee@eee@e.e..ee...ee..............e.....e.........",
        "..@@e@@@@@@e@@@@@@@@e@@@@................................@..@.@@@@@@e@@@@e@@e@@@e@@@e@@@e@@@@@e@@e@...",
        "w..............ee.e...eeeee@ee@ee@ee@ee@ee@ee@ee@ee@ee@eeeee...ee.............e...e.......ee.........w",
        "..@@e@@e@@e@@e@@@@@@e@@@@@............................@.@.@@@@@@@@@e@@e@@@@e@@@@e@@@@e@@e@@@@@e@@e@...",
        "..e..............e......e.ee@ee@ee@ee@ee@e@ee@ee@ee@eeee....eee..e......ee...e.....e........e.........",
        "w.@@@@e@@e@@e@@e@@@e@@e@@@@..........................@.@.@e@@@@@@@@e@@e@@@@e@@@@@e@@@@e@@@@@@@e@@e@..w",
        "...ee....................eeee@ee@ee@ee@ee@ee@ee@ee@ee.e........ee.............ee....e...eeee..........",
        "..@@@@@@e@@e@@e@@e@@e@@e@@@@........................@.@@e@@@@e@@@@@e@@e@@@e@@@@@@e@@@@e@@@@@@@@e@@e@..",
        "w.e..ee....................ee@ee@ee@ee@ee@ee@ee@eeee......ee.....e......e...ee.....e........ee.......w",
        "..@@@@@@@@eee@ee@e@ee@@e@@e@.......@.............@@@.@e@@@@@@@@e@@@e@@e@@@e@@@@@@e@@@e@@@@e@@@@@@e@@..",
        "...ee..ee..@................ee@ee@eee@ee@ee@eee@e.e.....ee..ee................ee.......ee.....ee...e..",
        "w.@@@@@@@@eee@ee@ee@eee@@e@@@................@.@...@e@e@@@@@@@@ee@ee@ee@ee@@e@@@@e@@@@@@@@@@e@@@@e@@.w",
        "..e..ee..............@.....e.eee@eee@ee@ee@eeeeee.........ee.......................eeee..ee...........",
        "..@@@@@@e@@e@@ee@ee@eee@@e@@@@@...@.......@.@.@.@@e@@e@@e@@@@@@e@@e@@e@@e@@e@@e@@e@@@@@@@@@@@@e@@e@...",
        "w..ee.......................e..eeeee@ee@eeee.e..............ee.........................ee..ee........w",
        "..@@@@e@@e@@e@ee@ee@ee@@e@@@@@@@@@.......@.@.@@e@@e@@@@e@@e@@@@e@@e@@@e@@e@@e@@e@@e@@e@@@@@@@@e@@e@...",
        "..e.......................ee.ee...eeee@ee...........ee..............e....................ee...........",
        "w.@@@e@@e@@ee@ee@eee@ee@@@@@@@@@e@@@@@.@@@@e@@@e@@e@@@@@@e@@e@@e@@e@@@e@@e@@e@@e@@@@@@@e@@@@@e@@@@e@.w",
        "...e..............@.....ee..e............e...e........ee.........................eeeee.....e...ee.....",
        "..@@@e@@@@ee@ee@eeee@ee@@@@@@@e@@e@@@e@@@@@e@@@@@e@@e@@@@e@@@e@@e@@e@@e@@e@@e@@e@@@@@@@@e@@@@e@@@@e@..",
        "w.e....ee........@........ee.......e...ee.....ee...........e..........................e...e..........w",
        "..@@@e@@@@ee@ee@eee@ee@@e@@@@@e@@e@@@e@@@@@e@@@@@e@@e@@@@e@@@@@e@@e@@e@@e@@e@@e@@e@@e@@@e@@@@e@@@e@e..",
        "...e........................e............e...e........ee....ee.............................e...e......",
        "w.@@@@e@@ee@ee@e@ee@ee@@@@e@@@e@@e@@e@@e@@@e@@@e@@@@e@@@@e@@@@@@@e@@e@@e@@e@@e@@e@@e@@e@@e@@@e@@@e@..w",
        "..e.e..................ee........................ee........e..ee......................................",
        "..@@@@@@e@ee@ee@ee@@@e@@@@e@@e@@@@e@@e@@@e@@e@@e@@@@@@e@@e@@@@@@@@@e@@ee@ee@ee@e@ee@ee@ee@ee@ee@ee@e..",
        "w..e.ee............e...........ee......e...........ee.......ee..ee...................................w",
        "..@@@@@@e@@e@@e@@e@@@@e@@@e@@e@@@@e@@e@@@e@@@@e@@e@@@@e@@@e@@@@@@@@e@@e@@e@@e@@e@@e@@e@@e@@e@@e@@e@...",
        "..e.e...............e...e..................ee...........e.....ee......................................",
        "w.@@@@e@@e@@e@@@@@e@@@@@@@e@@e@@e@@e@@e@@e@@@@@@e@@e@@e@@@e@@@@@@ee@ee@e@ee@e@ee@ee@ee@ee@ee@ee@ee@e.w",
        "...e..........eee....eee.....................ee.............ee........................................",
        "..@@@e@@@@e@@@@@@@@e@@@@@e@@e@@e@@e@@e@@@@@e@@@@@@e@@e@@@@e@@@@e@@ee@ee@ee@ee@ee@ee@ee@ee@ee@ee@ee@e..",
        "w.e....ee...ee...e.....................eee.....ee......ee............................................w",
        "..@@e@@@@@e@@@@e@@@@e@@e@@e@@@e@@e@@e@@@@@@e@@@@@@e@@e@@@@@e@@@e@@e@@@e@@@e@@@e@@e@@@e@@@@e@@@e@@e@...",
        "......e...........e.........e.........e......ee..........e...e......e...e...e......e...ee...e.........",
        "w.@@e@@@e@@e@@@@e@@@ee@e@ee@@@e@@e@@e@@@e@@e@@@@@e@@e@@e@@@e@@@ee@e@@@e@@@e@@@e@@e@@@e@@@@e@@@e@@@e@.w",
        "..e..........ee................................e................................................e.....",
        "..@@e@@e@@@e@@@@ee@ee@eee@ee@ee@ee@@e@@e@@e@@e@@@ee@ee@ee@ee@e@ee@e@ee@ee@ee@ee@ee@ee@ee@ee@ee@eee@e..",
        "w........e.............@........................................................................@....w",
        "..@e@@e@@@@ee@ee@ee@ee@ee@ee@ee@ee@ee@ee@ee@ee@ee@ee@ee@ee@ee@ee@ee@ee@ee@ee@ee@ee@ee@ee@ee@ee@eee@e..",
        "........e.............................................................................................",
        "w.@@@@e@@@e@@ee@ee@ee@ee@ee@ee@ee@ee@ee@ee@ee@ee@ee@ee@ee@ee@ee@e@ee@ee@ee@ee@ee@ee@ee@ee@ee@ee@ee@e.w",
        "..eee.................................................................................................",
        "..@@@@e@@e@@e@@ee@ee@ee@ee@ee@ee@ee@ee@ee@ee@ee@ee@ee@ee@ee@ee@ee@ee@ee@ee@ee@ee@ee@ee@ee@ee@ee@ee@e..",
        "w....................................................................................................w",
        "..e@@e@@@@e@@ee@ee@ee@ee@ee@ee@ee@ee@ee@ee@ee@ee@ee@ee@ee@ee@ee@ee@ee@ee@ee@ee@e@ee@ee@ee@ee@ee@ee@e..",
        ".......ee.............................................................................................",
        "w.e@ee@@@@ee@ee@ee@ee@ee@ee@ee@ee@ee@ee@ee@eee@ee@ee@ee@ee@ee@ee@ee@ee@ee@eee@ee@ee@ee@ee@ee@ee@ee@e.w",
        "............................................@..............................@..........................",
        "..e@ee@ee@ee@ee@ee@ee@ee@ee@ee@ee@ee@ee@ee@eee@ee@ee@ee@ee@ee@ee@ee@ee@ee@eee@ee@ee@ee@ee@ee@ee@ee@e..",
        "w....................................................................................................w",
        "..e@ee@ee@ee@ee@ee@ee@ee@ee@ee@ee@ee@ee@ee@ee@ee@ee@ee@ee@ee@ee@ee@ee@ee@ee@ee@ee@ee@ee@e@ee@ee@ee@e..",
        "......................................................................................................",
        "w.e@ee@ee@ee@ee@ee@ee@eee@ee@ee@ee@ee@ee@ee@ee@ee@eee@ee@ee@ee@ee@ee@ee@ee@ee@ee@ee@ee@ee@ee@ee@ee@e.w",
        ".......................@...........................@..................................................",
        "..e@ee@ee@ee@ee@ee@ee@eee@ee@ee@ee@ee@ee@ee@ee@ee@ee@ee@ee@ee@ee@ee@ee@ee@eee@ee@ee@ee@ee@ee@ee@ee@e..",
        "w..........................................................................@.........................w",
        "..e@ee@ee@ee@ee@ee@ee@ee@ee@eee@ee@ee@ee@ee@ee@ee@ee@ee@ee@ee@ee@ee@ee@ee@eee@ee@ee@ee@ee@ee@ee@ee@e..",
        ".............................@........................................................................",
        "w.e@ee@ee@ee@ee@ee@ee@ee@ee@eee@ee@ee@eee@ee@ee@ee@ee@ee@ee@ee@ee@ee@ee@ee@ee@ee@ee@ee@ee@ee@ee@ee@e.w",
        ".......................................@..............................................................",
        "..e@ee@ee@ee@ee@ee@ee@ee@ee@eee@ee@ee@eee@ee@ee@ee@ee@@e@@e@e@@e@@@@e@@@@@e@@e@@@e@@@e@@e@@@@e@@@e@e..",
        "w............................@...................................ee...eee......e...e......ee...e.....w",
        "..e@ee@ee@ee@ee@ee@ee@ee@ee@eee@ee@ee@ee@ee@ee@ee@ee@ee@@e@@e@@e@@@@e@@@@@e@@e@@@e@@@e@@e@@@@e@@@e@...",
        "......................................................................................................",
        "w.e@ee@ee@ee@ee@ee@ee@ee@ee@ee@e@ee@ee@ee@ee@ee@ee@ee@ee@ee@ee@ee@ee@ee@ee@ee@ee@ee@ee@ee@ee@ee@ee@e.w",
        "......................................................................................................",
        "..e@ee@ee@ee@ee@eee@ee@ee@ee@ee@ee@ee@ee@ee@ee@eee@ee@ee@ee@ee@ee@ee@ee@ee@ee@ee@ee@ee@ee@ee@ee@ee@e..",
        "w................@..............................@....................................................w",
        "..e@ee@ee@ee@ee@eee@ee@ee@ee@ee@ee@ee@ee@ee@ee@eee@ee@ee@ee@ee@ee@ee@ee@ee@ee@ee@ee@ee@ee@ee@ee@ee@e..",
        "......................................................................................................",
        "w.e@ee@ee@ee@ee@ee@ee@ee@eee@eee@ee@ee@ee@ee@ee@ee@ee@ee@ee@ee@ee@ee@ee@ee@ee@ee@ee@ee@ee@ee@ee@ee@e.w",
        "..........................@...@.......................................................................",
        "..e@ee@ee@ee@ee@ee@ee@ee@eee@eee@ee@ee@ee@ee@ee@ee@ee@ee@ee@ee@ee@ee@ee@ee@ee@ee@ee@ee@ee@ee@ee@ee@e..",
        "w....................................................................................................w",
        "..e@ee@ee@eee@ee@ee@ee@ee@ee@ee@ee@ee@ee@ee@ee@ee@ee@ee@ee@eee@ee@ee@ee@ee@ee@ee@ee@ee@ee@ee@ee@ee@e..",
        "...........@................................................@.........................................",
        "w.e@ee@ee@eee@ee@ee@ee@ee@ee@ee@ee@ee@ee@ee@ee@ee@ee@ee@ee@eee@ee@ee@ee@ee@ee@ee@ee@ee@ee@ee@ee@ee@e.w",
        "......................................................................................................",
        "..e@ee@ee@ee@ee@ee@ee@ee@ee@ee@ee@ee@ee@ee@ee@ee@ee@ee@ee@e@ee@ee@ee@ee@ee@ee@ee@ee@ee@ee@ee@ee@ee@e..",
        "......................................................................................................"
    ],
    "nca_runtime": null,
    "milp_runtime": null,
    "nca_milp_runtime": null,
    "weight": false,
    "n_row": 101,
    "n_col": 102,
    "n_endpoint": 2768,
    "n_agent_loc": 0,
    "maxtime": 5000
}