{
    "name": "kiva_xxlarge_cma-mae_global_opt_repaired_one_endpt_uneven_throughput-hamming_a=5_iter=200",
    "layout": [
        "...e.......................................e..........................................................",
        "w..@.@.@.@.@.@.@.@.@.@.@.@.@.@.@.@.@.@.@.@.@@e@.@.@.@.@.@.@.@.@.@.@.@.@.@.@.@.@.@.@.@.@.@.@.@.@.@.@..w",
        "...e.e.e.e.e.e.e.e.e.e.e.e.e.e.e.e.e.e.e.e.e..e.e.e.e.e.e.e.e.e.e.e.e.e.e.e.e.e.e.e.e.e.e.e.e.e.e.e@..",
        "...e.e.e.e.e.e.e.e.e.e.e.e.e.e.e.e.e@e................................................................",
        "w..@.@.@.@.@.@.@.@.@.@.@.@.@.@.@.@.e.e@@e@@e@@e@@e@@e@@e@@e@@e@@e@@e@@e@@e@@e@@e@@e@@e@@e@@@e@@e@@e@.w",
        "...e.e.e.e.e.e.e.e.e.e.e.e.e.e.e.e.@@e....................................................e...........",
        "...e.e.e.e.e.e.e.e.e.e.e.e.e.e.e.e.e.e@@e@@e@@e@@e@@e@@e@@e@@e@@e@@e@@e@@e@@@@e@@e@@e@@e@@@@e@@e@@e@..",
        "w..@.@.@.@.@.@.@.@.@.@.@.@.@.@.@.@.e@e.....................................ee............e...........w",
        "...e.e.e.e.e.e.e.e.e.e.e.e.e.e.e.e.e.e@@e@@e@@@@e@@e@@e@@@e@@e@@e@@e@@e@@e@@@@@@e@@e@@e@@@@e@@e@@e@@..",
        "...e.e.e.e.e.e.e.e.e.e.e.e.e.e.e.e.@.e.......ee.........e....................ee.........e..........e..",
        "w..@.@.@.@.@.@.@.@.@.@.@.@.@.@.@.@.e.@.@e@@e@@@@e@@e@@e@@@e@@@e@@@e@@e@@e@@e@@@@@@e@@e@@@@@e@@@@e@@@.w",
        "...e.e.e.e.e.e.e.e.e.e.e.e.e.e.e.e.e.e......................e...e..............ee......e.e...ee...e...",
        "...e.e.e.e.e.e.e.e.e.e.e.e.e.e.e.e.@.@.@e@@e@@e@@e@@e@@e@@e@@@e@@@e@@@@e@@e@@e@@@@@@e@@@@@@e@@@@e@@@..",
        "w..@.@.@.@.@.@.@.@.@.@.@.@.@.@.@.@.e.e..............................ee...........ee...e.e..........e.w",
        "...e.e.e.e.e.e.e.e.e.e.e.e.e.e.e.e.e.e.@e@@e@@e@@@e@@e@@e@@e@@e@@e@@@@@@@e@@e@@e@@@@e@@@@@e@@e@@@e@@..",
        "...e.e.e.e.e.e.e.e.e.e.e.e.e.e.e.e.@.@..........e..................e..ee...............e.......e......",
        "w..@.@.@.@.@.@.@.@.@.@.@.@.@.@.@.@.e.e@@e@@e@@e@@@@e@@e@@e@@e@@@e@@@@@@@@e@@e@@e@@e@@e@@@e@@@e@@@@e@.w",
        "...e.e.e.e.e.e.e.e.e.e.e.e.e.e.e.e.e@e...........e............e...e.ee.....................e....e.....",
        "...e.e.e.e.e.e.e.e.e.e.e.e.e.e.e.e.e.e@@e@@e@@e@@@@e@@e@@e@@e@@@e@@@@@@e@@@e@@e@@e@@e@@e@@@@@@e@@@e@..",
        "w..@.@.@.@.@.@.@.@.@.@.@.@.@.@.@.@.@.e@.........e..................e.....e...............ee.e........w",
        "...e.e.e.e.e.e.e.e.e.e.e.e.e.e.e.e.e.e@@e@@e@@e@@@@e@@e@@e@@e@@@e@@@@@e@@@@@e@@e@@e@@@@e@@@@@@e@@@e@..",
        "...e.e.e.e.e.e.e.e.@.e.e.e.e.e.e.e.e@e...........e............e.e.e.e.e.e.e.e.......ee.....e....e.....",
        "w..@.@.@.@.@.@.@.@.e.@.@.@.@.@.@.@.e.e@@e@@e@@e@@@@@e@@e@@e@@.@.@.@.@.@.@.@.@e@@@e@@@@@e@@@@@@e@@@...w",
        "...e.e.e.e.e.e.e.e.e.e.e.e.e.e.e.e.@.e..........e.e.........e.e.e.e.e.e.e.e.e..e...e.....ee.e....e@@..",
        "...e.e.e.e.e.e.e.e.@.e.e.e.e.e.e.e.e.@.@e@@e@@e@@@@@e@@@e@@.@.@.@.@.@.@.@.@.@.@@@e@@@@e@@@@@@@@....e..",
        "w..@.@.@.@.@.@.@.@.e.@.@.@.@.@.@.@.@.e...........e....e...e.e.e.e.e.e.e.e.e.e.e...e.e...e..e.ee@@e@@.w",
        "...e.e.e.e.e.e.e.e.e.e.e.e.e.e.e.e.e.e.@e@@e@@e@@@@@e@@@@.@.e.@.e@e.@@e.@.e@e.....e.e@@@@@@@@e........",
        "...e.e.e.e.e.e.e.e.@.e.e.e.e.e.e.e.e.@..........e.e....ee...@.e.e.e...e...e.e.@.@.@.@.ee.ee..@@e@@e@..",
        "w..@.@.@.@.@.@.@.@.e.@.@.@.@.@.@.@.@.e.@e@@e@@e@@@@@@e@@@@@.@.@.@.@.@.@.@.@.@.e.e.e.e.@@@@@.......e..w",
        "...e.e.e.e.e.e.e.e.e.e.e.e.e.e.e.e.e.e...........e.e.....ee.e.e.e.e.e.e.e.e.e.@.e.@.@.@.e.@@@e@@e@@@..",
        "...e.e.e.e.e.e.e.e.@.e.e.e.e.e.e.e.e.@.@@e@@e@@e@@@@@@@e@@@...@.e@e.@.@.@.@.@.e.@.e.e.e.e.ee.......e..",
        "w..@.@.@.@.@.@.@.@.e.@.@.@.@.@.@.@.@.e.e..........e.ee..........e.e...e...e...e.e.e.e.e.@.@@@e@@@e@@.w",
        "...e.e.e.e.e.e.e.e.e.e.e.e.e.e.e.e.e.e.@.@e@@e@@e@@@@@@@e@@.@.@.@.@.@.@.@.@.@.@.@.@.@.@.e.@.e..e......",
        "...e.e.e.e.e.e.e@e.@.e.e.e.e.e.e.e.e.@.e...........e..e.e.e.e.e.e.e.e.e.e.e.e.e.e.e.e.e.e.e.e.@@@e@@..",
        "w..@.@.@.@.@.@.e.e.e.@.@.@.@.@.@.@.@.e.e.@@e@@e@@@@@@@@@@@@.@.@.@.@.@.@.@.@.@.@.@.@.@.@.@.@.@.e.e..e.w",
        "...e.e.e.e.e.e.@.@.e.e.e.e.e.e.e.e.e.e.@.e......eee.ee.e.e....e.e.e.e.e.e.e.e.e.e.e.e.e.e.e.e.e.e.@@..",
        "...e.e.e.e.e.e.e.e.@.e.e.e.e.e.e.e.e.@.e.@@e@@e@@@@@@@@@@@@e@.@.@.@.@.@.@.@.@.@.@.@.@.@.@.@.@.@.@.e...",
        "w..@.@.@.@.@.@.e.e.e.@.@.@.@.@.@.@.@.e.e.e.........e..e.e.......e.e.e.e.e.e.e.e.e.e.e.e.e.e.e.e.e.e..w",
        "...e.e.e.e.e.e.@.@.e.e.e.e.e.e.e.e.e.e.@.@.@e@@e@@@@@@@@@@e@@e@.@.@.@.@.@.@.@.@.@.@.@.@.@.@.@.@.@.@...",
        "...e.e.e.e.e.e.e.e.@.e.e.e.e.e.e.e.e.@.e.e.......ee.ee.e..........e.e.e.@.e.e.e.@.e.e.e.e.e.e.e.e.e...",
        "w..@.@.@.@.@.@.e.e.e.@.@.@.@.@.@.@.@.e.e.e.@@@e@@@@@@@@@@e@@e@@e@.@.e.@.e.@.e.@.e.@.e.@.e@@.e@e.@.@..w",
        "...e.e.e.e.e.e.@.@.e.e.e.e.e.e.e.e.e.e.@.@.ee...e..e..e...........e.@.e.e.e.@.e.e.e.@.e.e.e.e.e.e.e...",
        "...e.e.e.e.e.e.e.e.@.e.e.e.e.e.e.e.e.@.e.e.@@@e@@@@@@@@@e@@.@.@.@.@.@.@.@.@.@.@.@.@.@.@.@.@.@.@.@.@...",
        "w..@.@.@.@.@.@.e.e.e.@.@.@.@.@.@.@.@.e.e.e.......ee.ee....e.e.e.e.e.e.e.e.e.e.e.e.e.e.e.e.e.e.e.e.e..w",
        "...e.e.e.e.e.e.@.@.e.e.e.e.e.e.e.e.e.e.@.@.@@e@e@@@@@@@@e@@@e.e.e.@.@.@.@.@.@.@.@.@.@.@.@.@.@.@.@.@...",
        "...e.e.e.e.e.e.e.e.@.e.e.e.e.e.e.e.e.@.e.e.e.......e..e....e..@.@.e.e.e.e.e.e.e.e.e.e.e.e.e.e.e.e.e...",
        "w..@.@.@.@.@.@.e.e.e.@.@.@.@.@.@.@.@.e.e.e.e.@e@@e@@@@@@@e@@@...e.e.@.@.@.e@e.@.@.@.@.@.@.@.@.@.@.@..w",
        "...e.e.e.e.e.e.@.@.e.e.e.e.e.e.e.e.e.e.@.@.@........ee.e....e.....@.e.e.@@e.e.e.e.e.e.e.e.e.@.e.e.e...",
        "...e.e.e.e.e.e.e.e.@.e.e.e.e.e.e.e.e.@.e.e.e.@@e@@e@@@@@@e@@@@@e@...e.@.e.e.@.e.@.e.@.e.@.e.e.e.e@e...",
        "w..@.@.@.@.@.@.e.e.e.@.@.@.@.@.@.@.@.e.e.e.e.e........e....e.e......@.e.e.@.e.@.e.@.e.@.e.@.e.@.e.e..w",
        "...e.e.e.e.e.e.@.@.e.e.e.e.e.e.e.e.e.e.@.@.@.@.@e@@e@@@@e@@@@@@@e@@.e...@.e.@.e.@.e.@.e.@.e.@.e.@.@...",
        "...e.e.e.e.e.e.e.e.@.e.e.e.e.e.e.e.e.@.e.e.e.e.......e....e.e.e...e...e.e.e...e.e.e.e.e.e.e.e.e.@.e...",
        "w..@.@.@.@.@.@.e.e.e.@.@.@.@.@.@.@.@.e.e.e.e.e.@@e@@@@@@e@@@@@@@e@@@e@@.@.@.@.@@e.@@e.@.e.@@e.@.e.@..w",
        "...e.e.e.e.e.e.@.@.e.e.e.e.e.e.e.e.e.e.@.@.@.@.e...ee.e....e.e........e.e.e.e.@.e.e.e.e.@.@.e.e.e.e...",
        "...e.e.e.e.e.e.e.e.@.e.e.e.e.e.e.e.e.@.e.e.e.e.@@e@@@@@@@e@@@@@@e@@e@@@.@.@.@.e.@@e.@.e.@.e.@.e.@.e...",
        "w..@.@.@.@.@.@.e.e.e.@.@.@.@.@.@.@.@.e.e.e.e.e.e..e..e.e.e..e.e......e....e...e...e...@.e.e...@.e.@..w",
        "...e.e.e.e.e.e.@.@.e.e.e.e.e.e.e.e.e.e.@.@.@.@.e.@@@@@@@@@@@@@@@e@@e@@@@@.@.@.@.@.@.@.@.@.@.@.@.e.@...",
        "...e.e.e.e.e.e.e.e.@.e.e.e.e.e.e.e.e.@.e.e.e.e.@.e.ee.e.e.ee.e........eee.e.e.e.e.e.e.e.e.e.e.e.@.e...",
        "w..@.@.@.@.@.@.e.e.e.@.@.@.@.@.@.@.@.e.e.e.e.e.e.e.@@@@@@@@@@@@e@@@e@@@@@.@.@.e@@.e@e.@.e@e.@.e@@.e@.w",
        "...e.e.e.e.e.e.@.@.e.e.e.e.e.e.e.e.e.e.@.@.@.@.e.@.e.e.e.e..e....e.e.e....e.e.e...e.e.e.e.e.e.e.e.e...",
        "...e.e.e.e.e.e.e.e.@.e.e.e.e.e.e.e.e.@.e.e.e.e.@.e.e.@.@.@.@@@@e@@@@@@@e@@e.e.@.@.@.@.@.@.@.@.@.@.@...",
        "w..@.@.@.@.@.@.e.e.e.@.@.@.@.@.@.@.@.e.e.e.e.e.e.e.@.e.e.e.e.e....e.e......e@...e.e.e.e.e.e.@.e.e.e..w",
        "...e.e.e.e.e.e.@.@.e.e.e.e.e.e.e.e.e.e.@.@.@.@.e.@.e.e.e.e.@.@.@.@@@@@e@.@.@.@e.@.@.@.@.e@e.e.@.@.@...",
        "...e.e.e.e.e.e.e.e.@.e.e.e.e.e.e.e.e.@.e.e.e.e.@.e.e.@.@.@.e.e.e.e.e.e...e.e.e..e.e.e.e.e.e.e.e.e.e...",
        "w..@.@.@.@.@.@.e.e.e.@.@.@.@.@.@.@.@.e.e.e@e.@.e.e.@.e.e.e.e.e.e.e.@.@.@.@.@.@.@e@e.e@e.@.@.@.@.@.@..w",
        "...e.e.e.e.e.e.@.@.e.e.e.e.e.e.e.e.e.e.@.@.e.e.e.@.e.e.e.e.@.@.@.@.e.e.e.e.e.e.ee.e.e.e.e.e.e.e.e.e...",
        "...e.e.e.e.e.e.e.e.@.@.e.e.e.e.e.e.e.@.e.e.@.e.@.e.e.@.@.@.e.e.e.e.e.e.e.e.e.e.@@.@.@.@.e.e.e@e.e@e...",
        "w..@.@.@.@.@.@.e.e.e.e.@.@.@.@.@.@.@.e.e.e.e.@.e.e.@.e.e.e.e.e.e.e.@.@.@.@.@.@.e..@.e.e.@.@.e.e@e.e..w",
        "...e.e.e.e.e.e.@.@.e.e.e.e.e.e.e.e.e.e.@.@.e.e.e.@.e.e.e.e.@.@.@.@.e.e.e.e.e.e.e..e.e@e.e.e.@.e.@.@...",
        "...e.e.e.e.e.e.e.e.@.@.e.e.e.e.e.e.e.@.e.e.@.e.@.e.e.@.@.@.e.e.e.e.e.e.e@e.e@e.@@.e@e.......e.@.e.e...",
        "w..@.@.@.@.@.@.e.e.e.e.@.@.@.@.@.@.@.e.e@e.e.@.e.e.@.e.e.e.e.e.e@e.@.@........eee.............e.e.e..w",
        "...e.e.e.e.e.e.@.@.e.e.e.e.e.e.e.e.e.e.e.e@e.e.e.@.e.e.e.e.@.@.e.e.e.e.@@@e@@@@@@@@e@@e@@e@.....@.@...",
        "...e.e.e.e.e.e.e.e.@.@.e.e.e.e.e.e.e.@.@.e.e.e.@.e.e.@.@.@.e.e.@.@.....ee...ee...e..............e.e...",
        "w..@.@.@.@.@.@.e.e.e.e.@.@.@.@.@.@.@.e.e.@.@.@.e.e.@.e.e.e.e.e.e.e.@e@@@@@e@@@@e@@@e@@e@@e@@e@@.e@e..w",
        "...e.e.e.e.e.e.@.@.e.e.e.e.e.e.e.e.e.e.e.e.e.e.e.@.e.e.e.e.@.@.e......e.......................e...e...",
        "...e.e.e.e.e.e.e.e.@.@.e.e.e.e.e.e.e.@.@.e.e.e.@.e.e.@.@.@.e.e.@@e@@e@@@@e@@e@@@e@@e@@e@@e@@e@@@e@@@..",
        "w..@.@.@.@.@.@.e.e.e.e.@.@.@.@.@.@.@.e.e.@.@.@.e.e.@.e.e.e.............e......e....................e.w",
        "...e.e.e.e.e.e.@.@.e.e.e.e.e.e.e.e.e.e.e.e.e.e.e.@.e.....e@@e@@e@@e@@e@@@e@@e@@@e@@e@@e@@@@e@@e@@e@@..",
        "...e.e.e.e.e.e.e.e.@.@.e.e.e.e.e.e.e.@.@.e.e.e.@.e......................................ee............",
        "w..@.@.@.@.@.@.e.e.e.e.@.@.@.@.@.@.@.e.e.@.@.@.e.e@@e@@@e@@e@@e@@e@@e@@e@@e@@e@@e@@e@@e@@@@@e@@e@@e@.w",
        "...e.e.e.e.e.e.@.@.e.e.e.e.e.e.e.e.e.e.e.e.e.e........e...................................e...........",
        "...e.e.e.e.e.e.e.e.@.@.@.e.e.e@e.e.e.@.@.e.e.e@@e@@e@@e@@e@@e@@e@@e@@e@@e@@e@@e@@e@@e@@e@@@@e@@e@@e@..",
        "w..@.@.@.@.@.@.e.e.e.e.e.@.@.e.e.@.@.e.e.@.@.............................................e...........w",
        "...e.e.e.e.e.e.@.@.e.e.e.e.e.@.@.e.e.e.e.e.e.@@e@@e@@e@@@e@@e@@e@@e@@e@@e@@e@@e@@e@@e@@e@@e@@e@@@@e@..",
        "...e.e.e.e.e.e.e.e.@.@.@.e.e.e.e.e.e.@.@.e...e.........e.......................................ee.....",
        "w..@.@.@.@.@.@.e.e.e.e.e.@.@.e.e.@.@.e.e.@@e@@@e@@e@@e@@@e@@e@@e@@e@@e@@e@@e@@e@@e@@e@@e@@e@@e@@@@e@.w",
        "...e.e.e.e.e.e.@.@.e.e.e.e.e.@.@.e.e.e................................................................",
        "...e.e.e.e.e.e.e.e.@.@.@.e.e.e.e.e@e.@@e@@@@e@@e@@e@@e@@e@@e@@e@@e@@e@@e@@e@@@e@@e@@e@@@e@@@e@@e@@e@..",
        "w..@.@.@.@.@.@.e.e.e.e.e.@.@.............ee.................................e.........e...e..........w",
        "...e.e.e.e.e.e.@.@.e.e.e.e.e.@e@@e@@e@@e@@@@e@@e@@e@@e@@e@@e@@e@@e@@e@@e@@e@@@e@@e@@e@@@e@@@@@e@@e@@..",
        "...e.e.e.e.e.e.e.e.@.@.@.e.................................................................ee......e..",
        "w..@.@.@.@.@.@.e.e.e.e.e.@@@@e@@e@@e@@e@@e@@e@@e@@e@@e@@e@@e@@e@@e@@e@@e@@e@@e@@e@@e@@e@@e@@@@e@@e@@.w",
        "...e.e.e.e.e.e.@.@.e......ee..........................................................................",
        "...e.e.e.e.e@e.e.e.@@e@@e@@@@e@@e@@e@@e@@e@@e@@e@@e@@e@@e@@@e@@e@@e@@@e@@@e@@e@@@e@@@e@@e@@e@@@e@@e@..",
        "w..@.@.@.@................................................e.........e...e......e...e.........e.......w",
        "...e.e.e.e.e@@e@@e@@e@@e@@e@@e@@e@@e@@e@@e@@e@@e@@e@@e@@e@@@e@@e@@e@@@e@@@e@@e@@@e@@@e@@e@@e@@@e@@e@..",
        "...e.e.e.e............................................................................................",
        "w..@.@.@.@.@@@e@@@e@@@e@@e@@e@@e@@@e@@e@@e@@e@@e@@e@@e@@e@@@e@@e@@@@e@@e@@e@@@e@@e@@e@@e@@@e@@e@@@e@.w",
        "...e.e.e.e.ee...e...e............e........................e......ee.........e............e......e.....",
        "..@e.e@e.e@@@@e@@@e@@@e@@e@@e@@e@@@e@@e@@e@@e@@e@@e@@e@@e@@@e@@e@@@@e@@e@@e@@@e@@e@@e@@e@@@e@@e@@@e@..",
        "......................................................................................................"
    ],
    "nca_runtime": null,
    "milp_runtime": null,
    "nca_milp_runtime": null,
    "weight": false,
    "n_row": 101,
    "n_col": 102,
    "n_endpoint": 2524,
    "n_agent_loc": 0,
    "maxtime": 5000
}