{
    "name": "kiva_xxlarge_cma-mae_global_opt_repaired_one_endpt_throughput-hamming_a=5_iter=200",
    "layout": [
        "......................................................................................................",
        "w.e@ee@@ee@@ee@@ee@@ee@@ee@@ee@@ee@@ee@@ee@@ee@@ee@@ee@@ee@@ee@@ee@@ee@@ee@@ee@@ee@@ee@@ee@@ee@@eee@.w",
        ".................................................................................................@....",
        "..@@ee@@ee@@ee@@ee@@ee@@ee@@ee@@ee@@ee@@ee@@ee@@ee@@ee@@ee@@ee@@ee@@ee@@ee@@ee@@ee@@ee@@ee@@ee@@e@ee..",
        "w.e................................................................................................@.w",
        "..@@ee@@ee@@ee@@ee@@ee@@ee@@ee@@ee@@ee@@ee@@ee@@ee@@ee@@ee@@ee@@ee@@ee@@ee@@ee@@ee@@ee@@ee@@ee@@eee@..",
        ".................................................................................................@.e..",
        "w.@@ee@@ee@@ee@@ee@@ee@@ee@@ee@@ee@@ee@@ee@@ee@@ee@@ee@@ee@@ee@@ee@@ee@@ee@@ee@@ee@@ee@@ee@@ee@@ee@@.w",
        "..e...................................................................................................",
        "..@@ee@@ee@@ee@@ee@@ee@@ee@@ee@@ee@@ee@@ee@@ee@@ee@@ee@@ee@@ee@@ee@@ee@@ee@@ee@@ee@@ee@@ee@@ee@@ee@e..",
        "w....................................................................................................w",
        "..@@ee@@ee@@ee@@ee@@ee@@ee@@ee@@ee@@ee@@ee@@ee@@ee@@ee@@ee@@ee@@ee@@ee@@ee@@ee@@ee@@ee@@ee@@ee@@eee@..",
        "..e..............................................................................................@.e..",
        "w.@@ee@@ee@@ee@@ee@@ee@@ee@@ee@@ee@@ee@@ee@@ee@@ee@@ee@@ee@@ee@@ee@@ee@@ee@@ee@@ee@@ee@@ee@@ee@@ee@@.w",
        "......................................................................................................",
        "..@@ee@@ee@@ee@@ee@@ee@@ee@@ee@@ee@@ee@@ee@@ee@@ee@@ee@@ee@@ee@@ee@@ee@@ee@@ee@@ee@@ee@@ee@@ee@@ee@e..",
        "w.e..................................................................................................w",
        "..@@ee@@ee@@ee@@ee@@ee@@ee@@ee@@ee@@ee@@ee@@ee@@ee@@ee@@ee@@ee@@ee@@ee@@ee@@ee@@ee@@ee@@ee@@ee@@e@e@..",
        "...................................................................................................e..",
        "w.@@ee@@ee@@ee@@ee@@ee@@ee@@ee@@ee@@ee@@ee@@ee@@ee@@ee@@ee@@ee@@ee@@ee@@ee@@ee@@ee@@ee@@ee@@ee@@ee@@.w",
        "..e...................................................................................................",
        "..@@ee@@ee@@ee@@ee@@ee@@ee@@ee@@ee@@ee@@ee@@ee@@ee@@ee@@ee@@ee@@ee@@ee@@ee@@ee@@ee@@ee@@ee@@ee@@ee@e..",
        "w....................................................................................................w",
        "..@@ee@@ee@@ee@@ee@@ee@@ee@@ee@@ee@@ee@@ee@@ee@@ee@@ee@@ee@@ee@@ee@@ee@@ee@@ee@@ee@@ee@@ee@@ee@@e@e@..",
        "..e................................................................................................e..",
        "w.@@ee@@ee@@ee@@ee@@ee@@ee@@ee@@ee@@ee@@ee@@ee@@ee@@ee@@ee@@ee@@ee@@ee@@ee@@ee@@ee@@ee@@ee@@ee@@ee@@.w",
        "......................................................................................................",
        "..@@ee@@ee@@ee@@ee@@ee@@ee@@ee@@ee@@ee@@ee@@ee@@ee@@ee@@ee@@ee@@ee@@ee@@ee@@ee@@ee@@ee@@ee@@ee@@ee@e..",
        "w.e..................................................................................................w",
        "..@@ee@@ee@@ee@@ee@@ee@@ee@@ee@@ee@@ee@@ee@@ee@@ee@@ee@@ee@@ee@@ee@@ee@@ee@@ee@@ee@@ee@@ee@@ee@@ee@@..",
        "...................................................................................................e..",
        "w.@@ee@@ee@@ee@@ee@@ee@@ee@@ee@@ee@@ee@@ee@@ee@@ee@@ee@@ee@@ee@@ee@@ee@@ee@@ee@@ee@@ee@@ee@@ee@@ee@@.w",
        "..e...................................................................................................",
        "..@@ee@@ee@@ee@@ee@@ee@@ee@@ee@@ee@@ee@@ee@@ee@@ee@@ee@@ee@@ee@@ee@@ee@@ee@@ee@@ee@@ee@@ee@@ee@@ee@e..",
        "w....................................................................................................w",
        "..@@ee@@ee@@ee@@ee@@ee@@ee@@ee@@ee@@ee@@ee@@ee@@ee@@ee@@ee@@ee@@ee@@ee@@ee@@ee@@ee@@ee@@ee@@ee@@eee@..",
        "..e..............................................................................................@.e..",
        "w.@@ee@@ee@@ee@@ee@@ee@@ee@@ee@@ee@@ee@@ee@@ee@@ee@@ee@@ee@@ee@@ee@@ee@@ee@@ee@@ee@@ee@@ee@@ee@@ee@@.w",
        "......................................................................................................",
        "..@@ee@@ee@@ee@@ee@@ee@@ee@@ee@@ee@@ee@@ee@@ee@@ee@@ee@@ee@@ee@@ee@@ee@@ee@@ee@@ee@@ee@@ee@@ee@@ee@e..",
        "w.e..................................................................................................w",
        "..@@ee@@ee@@ee@@ee@@ee@@ee@@ee@@ee@@ee@@ee@@ee@@ee@@ee@@ee@@ee@@ee@@ee@@ee@@ee@@ee@@ee@@ee@@ee@@ee@@..",
        "...................................................................................................e..",
        "w.@@ee@@ee@@ee@@ee@@ee@@ee@@ee@@ee@@ee@@ee@@ee@@ee@@ee@@ee@@ee@@ee@@ee@@ee@@ee@@ee@@ee@@ee@@ee@@ee@@.w",
        "..e...................................................................................................",
        "..@@ee@@ee@@ee@@ee@@ee@@ee@@ee@@ee@@ee@@ee@@ee@@ee@@ee@@ee@@ee@@ee@@ee@@ee@@ee@@ee@@ee@@ee@@ee@@ee@e..",
        "w....................................................................................................w",
        "..@@ee@@ee@@ee@@ee@@ee@@ee@@ee@@ee@@ee@@ee@@ee@@ee@@ee@@ee@@ee@@ee@@ee@@ee@@ee@@ee@@ee@@ee@@ee@@e@e@..",
        "..e................................................................................................e..",
        "w.@@ee@@ee@@ee@@ee@@ee@@ee@@ee@@ee@@ee@@ee@@ee@@ee@@ee@@ee@@ee@@ee@@ee@@ee@@ee@@ee@@ee@@ee@@ee@@ee@@.w",
        "......................................................................................................",
        "..@@ee@@ee@@ee@@ee@@ee@@ee@@ee@@ee@@ee@@ee@@ee@@ee@@ee@@ee@@ee@@ee@@ee@@ee@@ee@@ee@@ee@@ee@@ee@@ee@e..",
        "w.e..................................................................................................w",
        "..@@ee@@ee@@ee@@ee@@ee@@ee@@ee@@ee@@ee@@ee@@ee@@ee@@ee@@ee@@ee@@ee@@ee@@ee@@ee@@ee@@ee@@ee@@ee@@eee@..",
        "...................................................................e...e.........................@....",
        "w.@@ee@@ee@@ee@@ee@@ee@@ee@@ee@@ee@@ee@@ee@@ee@@ee@@ee@@ee@@ee@@ee@@@e@@@e@@ee@@ee@@ee@@ee@@ee@@eee@.w",
        "..e....................................................e..................................e...........",
        "..@@ee@@ee@@ee@@ee@@ee@@ee@@ee@@ee@@ee@@ee@@ee@@ee@@ee@@@ee@.........e@@..e@.e...e.....@......e@..e@..",
        "w.........................................................e@@@ee@@ee@e.e.@e..@@ee@@ee@@e..@ee@e@e.e..w",
        "..@@ee@@ee@@ee@@ee@@ee@@ee@@ee@@ee@@ee@@ee@@@e@@e@@e.e......e.....................................@@..",
        "..e........................................e.....ee.e@ee@@ee@@ee@@ee@@@ee@@ee@@ee@@ee@@ee@@ee@@e@@ee..",
        "w.@@ee@@ee@@ee@@ee@@ee@@ee@@ee@@ee@@ee@@ee@@@ee......................e...............................w",
        "..............................................@e@@ee@@ee@@ee@@ee@@e@e@@ee@@e@e@@e@@ee@@ee@@ee@@ee@e@..",
        "..@@ee@@ee@@ee@@ee@@ee@@ee@@ee@@ee@@ee@@ee............................................................",
        "w.e............................e.......e.@.e@@ee@@ee@@ee@@ee@@ee@@ee@@e@e@@ee@@eee@@e@@ee@@ee@@ee@@e.w",
        "..@@ee@@ee@@ee@@ee@@ee@@ee@@ee@@@e.@............................................@.....................",
        "...................................e.@@ee@@e@@ee@@ee@@ee@@ee@@ee@@ee@@eee@@ee@@eee@@ee@@e@@ee@@ee@e@..",
        "w.@@ee@@ee@@ee@@ee@@ee@@ee@@@ee@.e...e.................................@.............................w",
        "..e........................e.....@@ee@@ee@@ee@@e@@ee@@ee@@ee@@ee@@ee@@eee@@ee@@ee@@eee@@ee@@e@@ee@e@..",
        "..@@ee@@ee@@ee@@ee@@ee@@ee@@@ee@.e.....................................@............@.................",
        "w..................e..............@ee@@ee@@ee@@ee@@e@@ee@@ee@@ee@@ee@@eee@@ee@@ee@@ee@@eee@@e@@ee@@e.w",
        "..@@ee@@ee@@ee@@ee@@@ee@@ee@@ee@@e........................@............@................@.............",
        "..e................................ee@@ee@@ee@@ee@@ee@ee@@ee@@ee@@ee@@ee@@@ee@@ee@@ee@@eee@@ee@@e@e@..",
        "w.@@ee@@ee@@ee@@@ee@@ee@@ee@@ee@@e.@..........................@..........e...........................w",
        "...............e....................e@@ee@@ee@@ee@@ee@@e@@ee@@ee@@ee@@ee@@@ee@@ee@@ee@@ee@@ee@@ee@@@..",
        "..@@ee@@ee@@ee@@@ee@@ee@@ee@@ee@@@e..e............................................................ee..",
        "w.e.............................e....@@ee@@ee@@ee@@ee@@e@@ee@@ee@@ee@@e@e@@ee@@ee@@ee@@ee@@ee@@ee@@e.w",
        "..@@ee@@ee@@ee@ee@ee@@ee@@e@@ee@@@e@..................................................................",
        "......................................@ee@@ee@@ee@@ee@@ee@@e@@ee@@ee@@eee@@ee@@ee@@ee@@ee@@ee@@ee@e@..",
        "w.e@@e@@ee@@e@@ee@@e@@ee@@ee@@ee@@ee@e.............@...................@.............................w",
        "...................................@..@ee@@ee@@ee@@ee@@ee@@ee@@e@@ee@@eee@@ee@@ee@@ee@@ee@@ee@@ee@@@..",
        "..e@@ee@@@eee@@ee@@ee@@e@@ee@@ee@@eee@e................................@..........................ee..",
        "w.......e..@.............................@@ee@@ee@@ee@@ee@@ee@@ee@@e@@eee@@ee@@ee@@ee@@ee@@ee@@ee@@@.w",
        "..e@@ee@@@ee@@ee@@ee@@ee@@ee@@e@@e@ee@@e@ee...........................................................",
        ".............................................@@ee@@ee@@ee@@ee@@ee@@ee@@e@@@ee@@ee@@ee@@ee@@ee@@ee@@e..",
        "w.e@@@ee@@ee@@ee@@ee@@ee@@ee@@e@@e@@e@@ee@@eeee..........................e...........................w",
        "....e.......................................@....@@ee@@ee@@ee@@ee@@ee@@ee@@ee@@ee@@ee@@ee@@eee@@e@ee..",
        "..ee@@ee@@ee@@ee@@ee@@ee@@ee@@e@@e@@e@@ee@@ee@@e@e..........................................@......@..",
        "w.@................................................ee@@ee@@ee@@ee@@ee@@ee@@ee@@ee@@ee@@ee@@ee@@@eee@.w",
        "..ee@@ee@@ee@@ee@@ee@@ee@@ee@@ee@e@@ee@ee@@ee@e@@@e@..........................................e..@.e..",
        "..................................e.............e.....@ee@@ee@@ee@@ee@@ee@@ee@@ee@@ee@@ee@@ee@@@ee@@..",
        "w.ee@@ee@@ee@@ee@@ee@@ee@@ee@@eee@@@ee@ee@@e@@ee@@ee@@e..............................................w",
        "..@............................@...@....................e@@ee@@ee@@ee@@ee@@ee@@ee@@ee@@ee@@ee@@ee@ee..",
        "..ee@@ee@@ee@@ee@@ee@@ee@@ee@@ee@@eee@@ee@@e@@ee@@ee@@e@e..........................................@..",
        "w.@....................................@...................ee@@ee@@ee@@ee@@ee@@ee@@ee@@ee@@ee@@ee@e@.w",
        "..ee@@ee@@ee@@ee@@ee@@ee@@ee@@ee@@ee@@eee@@ee@@e@@ee@@ee@ee@..................................e.......",
        "..............................................................@ee@@ee@@ee@@ee@@ee@@ee@@ee@@ee@@@e@@e..",
        "w.ee@@ee@@ee@@ee@@ee@@ee@@ee@@ee@@ee@@ee@@eee@@ee@ee@@ee@@e@@ee......................................w",
        "..@........................................@.....e...e...........@@ee@@ee@@ee..e..@ee@@ee@@ee@....@...",
        "..ee@@ee@@ee@@ee@@ee@@ee@@ee@@ee@@ee@@ee@@ee@@ee@@@e@@@e@@e@@ee@.e..........@.e@.e@@e.@e...@e.e@e@e@..",
        "......................................................................@ee@@e.........................."
    ],
    "nca_runtime": null,
    "milp_runtime": null,
    "nca_milp_runtime": null,
    "weight": false,
    "n_row": 101,
    "n_col": 102,
    "n_endpoint": 2456,
    "n_agent_loc": 0,
    "maxtime": 5000
}