{
    "name": "kiva_large_200_agents_cma-me_opt_avg_turn",
    "weight": false,
    "n_row": 33,
    "n_col": 36,
    "n_endpoint": 305,
    "n_agent_loc": 0,
    "maxtime": 5000,
    "layout": [
        ".................................e..",
        "w.e@e@e@e@e@e@e@e@e@e@e@e@e@e@e@e@.w",
        "....................................",
        "...ee.ee.ee.ee.ee.ee.ee.ee.ee.ee.e..",
        "w.e@@e@@e@@e@@e@@e@@e@@e@@e@@e@@e@.w",
        "..e.................................",
        "..@e@e@e@e@e@e@e@e@e@e@e@e@e@e@e@e..",
        "w..................................w",
        "...ee.ee.ee.ee.ee.ee.ee.ee.ee.ee.e..",
        "..e@@e@@e@@e@@e@@e@@e@@e@@e@@e@@e@..",
        "w.ee...............................w",
        "..@e@e@e@e@e@e@e@e@e@e@e@e@e@e@e@e..",
        "....................................",
        "w..ee.ee.ee.ee.ee.ee.ee.ee.ee.ee.e.w",
        "..e@@e@@e@@e@@e@@e@@e@@e@@e@@e@@e@..",
        "..ee................................",
        "w.@e@e@e@e@e@e@e@e@e@e@e@e@e@e@e@e.w",
        "....................................",
        "...ee.ee.ee.ee.ee.ee.ee.ee.ee.ee.e..",
        "w.e@@e@@e@@e@@e@@e@@e@@e@@e@@e@@e@.w",
        "..e.................................",
        "..@e@e@e@e@e@e@e@e@e@e@e@e@e@e@e@e..",
        "w..................................w",
        "..ee.ee.ee.ee.ee.ee.eee@eeee@eee.e..",
        "..@@e@@e@@e@@e@@e@@e@@e@e@@e@e@@e@..",
        "w.e................................w",
        "..@e@e@e@e@e@e@e@e@e@e@e@e@e@e@e@e..",
        "....................................",
        "w..ee.ee.ee.ee.ee.ee.ee.ee.ee.ee.e.w",
        "..e@@e@@e@@e@@e@@e@@e@@e@@e@@e@@e@..",
        "..ee................................",
        "w.@e@e@e@e@e@e@e@e@e@e@e@e@e@e@e@e.w",
        "..e................................."
    ]
}