{
    "name": "kiva_large_200_agents_cma-me_opt",
    "weight": false,
    "n_row": 33,
    "n_col": 36,
    "n_endpoint": 264,
    "n_agent_loc": 0,
    "maxtime": 5000,
    "layout": [
        "...............................ee...",
        "w.e@e@e@e@e@e@e@e@e@e@e@e@e@e@e@@..w",
        "................................e...",
        "..e@ee@e@e@e@ee@ee@e@e@e@e@e@e@e@...",
        "w..................................w",
        "..e@e@e@e@e@ee@e@e@e@e@e@e@e@e@e@...",
        "................................e...",
        "w.e@e@e@e@e@ee@e@e@e@e@e@e@e@e@e@..w",
        "....................................",
        "..e@e@e@ee@e@e@e@e@e@e@e@e@e@e@e@...",
        "w...............................e..w",
        "..e@e@e@e@ee@e@e@e@e@e@e@e@e@e@e@...",
        "....................................",
        "w.e@e@e@e@ee@e@e@e@e@e@e@e@e@e@e@..w",
        "................................e...",
        "..e@e@e@e@ee@e@e@e@e@e@e@e@e@e@e@...",
        "w..................................w",
        "..e@e@e@e@ee@e@e@e@e@e@e@e@e@e@e@...",
        "................................e...",
        "w.e@e@e@e@e@ee@e@e@e@e@e@e@e@e@e@..w",
        "....................................",
        "..e@e@e@e@e@e@ee@e@e@e@e@e@e@e@e@...",
        "w...............................e..w",
        "..e@e@e@e@e@e@e@e@e@e@e@e@e@ee@e@...",
        "....................................",
        "w.e@e@e@e@e@ee@e@e@e@e@e@e@e@e@e@..w",
        "................................e...",
        "..e@e@e@e@e@e@e@e@e@e@e@ee@e@e@e@...",
        "w..................................w",
        "...e@e@e@e@e@e@e@e@e@e@e@e@e@e@e@...",
        "................................e...",
        "w..e@e@e@e@e@e@e@e@e@e@e@e@e@e@e@..w",
        "...................................."
    ]
}