{
    "name": "kiva_xxlarge_cma-mae_global_opt_repaired_one_endpt_uneven_w",
    "weight": false,
    "n_row": 101,
    "n_col": 102,
    "n_endpoint": 40,
    "n_agent_loc": 40,
    "maxtime": 5000,
    "layout": [
        "...e.e.e.@e@@e@@e@@e@@e@@e@@e@@e@@ee@e@@e@@e@@e@@e@@e@@e@@e@@e@@e@@e@@e@@e@@e@@e@@e@@e@@@e@@e@@e@@e@..",
        "w..@.@.@...............................................................................e.............w",
        "...e.e.e...........................................................................................e..",
        "...e.e.e.@e@@e@@e@@e@@e@@e@@e@@e@@e@@e@@e@@e@@e@@e@@e@@e@@e@@e@@e@@e@@e@@e@@e@@e@@e@@e@@e@@e@@e@@e@@..",
        "w..@.@.@.............................................................................................w",
        "...e.e.e.e@@.......................................................................................e..",
        "...e.e.e.e.e.@e@@e@@e@@e@@e@@e@@e@@e@@e@@e@@e@@e@@e@@e@@e@@e@@e@@e@e@@e@@e@@e@@e@@e@@e@@e@@e@@e@@e@@..",
        "w..@.@.@.@.e.........................................................................................w",
        "...e.e.e.e.@.e@@...................................................................................e..",
        "...e.e.e.e.e.e.e.@@e@@e@@e@@e@@e@@e@@e@@e@@e@@e@@e@@e@@e@@e@@e@@e@@e@@e@@e@@e@@e@@e@@e@@e@@e@@e@@e@@..",
        "w..@.@.@.@.e.@.e.e...................................................................................w",
        "...e.e.e.e.@.e.@.e@@...............................................................................e..",
        "...e.e.e.e.e.e.e.e.e.@e@@e@@e@@e@@e@@e@@e@@e@@e@@e@@e@@e@@e@@e@@e@@e@@e@@e@@e@@e@@e@@e@@e@@e@@e@@e@@..",
        "w..@.@.@.@.e.@.e.@.e.................................................................................w",
        "...e.e.e.e.@.e.@.e.@.e@@...........................................................................e..",
        "...e.@.e.e.e.e.e.e.e.e.e.@e@e@@e@@e@@e@@e@@e@@e@@e@@e@@e@@e@@e@@e@@e@@e@@e@@e@@e@@e@@e@@e@@e@@e@@e@@..",
        "w..@.e.@.@.e.@.e.@.e.@.e.............................................................................w",
        "...e.e.e.e.@.e.@.e.@.e.@.e@@.........................e.............................................e..",
        "...e.@.e.e.e.e.e.e.e.e.e.e.e.@e@@e@@e@@e@@e@@e@@e@@e@@@e@@e@@e@@e@@e@@e@@e@@e@@e@@e@@e@@e@@e@@e@@e@@..",
        "w..@.e.@.@.e.@.e.@.e.@.@.@.e.........................................................................w",
        "...e.e.e.e.@.e.@.e.@.e.e.e.@.e@@......................................................................",
        "...e.@.e.e.e.e.e.e.e.e.e.e.e.e.e.@e@@e@@e@@e@@e@@e@@e@@e@@e@@e@@e@@e@@e@@e@@e@@e@@e@@@e@@e@@e@@e@@e@..",
        "w..@.e.@.@.e.@.e.@.e.@.@.@.e.@.e....................................................e................w",
        "...e.e.e.e.@.e.@.e.@.e.e.e.@.e.@.e@@.............................................................@e@..",
        "...e.@.e.e.e.e.e.e.e.e.e.e.e.e.e.e.e.@e@@e@@e@@e@@e@@e@@e@@e@@e@@e@@e@@e@@e@@e@@e@@e@@e@@e@@e@e@......",
        "w..@.e.@.@.e.@.e.@.e.@.@.@.e.@.e.@.e...............................................................@.w",
        "...e.e.e.e.@.e.@.e.@.e.e.e.@.e.@.e.@.e@@...................@.e@@e@@@e@@e@@e@@e@@e@.............@e@.e..",
        "...e.@.e.e.e.e.e.e.e.e.e.e.e.e.e.e.e.e.e.@e@@e@@e@@e@@e@@e.e.@....e................e@@e@@e@@e@..e..@..",
        "w..@.e.@.@.e.@.e.@.e.@.@.@.e.@.@.@.e.@.e.................e...e.@e@@@@e@@e@@e@@e@@e@@............@@...w",
        "...e.e.e.e.@.e.@.e.@.e.e.e.@.e.e.e.@.e.@.e@@.......e@e...@..@e@....e......................e@@e@..e.@..",
        "...e.@.e.e.e.e.e.e.e.e.e.e.e.e.e.e.e.e.e.e.e.@e@@e@@....@e@.....@e@@@e@@e@@e@@e@@e@@e@@e@@e......@@e..",
        "w..@.e.@.@.e.@.e.@.e.@.@.@.e.@.@.@.e.@.e.@.e........@e@......@e@............................@@e@.....w",
        "...e.e.e.e.@.e.@.e.@.e.e.e.@.e.e.e.@.e.@.e.@.e.e@@e......@e@.......@e@@e@@e@@e@@e@@e@@e@@e@@e.....@@..",
        "...e.@.e.e.e.e.e.e.e.e.e.e.e.e.e.e.e.e.e.e.e.@.e.....@e@.....e@@e@..........................e@@e@.ee..",
        "w..@.e.@.@.e.@.e.@.e.@.@.@.e.@.@.@.e.@.e.@.e.e.@..@e......@e@.....e@@e@@e@@e@@e@@e@@e@@e@@e@@.....@@.w",
        "...e.e.e.e.@.e.@.e.@.e.e.e.@.e.e.e.@.e.@.e.@.e.e......@e@......@e@@..........................e@@e@.e..",
        "...e.@.e.e.e.e.e.e.e.e.e.e.e.e.e.e.e.e.e.e.e.@.e.e@@e......@e@......@@e@@e@@e@@e@@e@@e@@e@@e@@.....@..",
        "w..@.e.@.@.e.@.e.@.@.@.@.@.e.@.@.@.@.@.e.@.e.e.@.e@....@e@......@e@@e...........................@@...w",
        "...e.e.e.e.@.e.@.e.e.e.e.e.@.e.e.@.e.e.@.e.@.e.e.ee.@e......@e@......@@e@@e@@@e@@e@@e@@e@@e@@e@@ee....",
        "...e.@.e.e.e.e.e.e.e.e.e.e.e.e.e.e.e.e.e.e.e.@.e.@@.....@e@......@e@@e......e...................e@....",
        "w..@.e.@.@.e.@.e.@.@.@.@.@.e.@.@.e.@.@.e.@.e.e.@....@e@......@e@......@e@@e@@@e@@e@@e@@@e@@e@@e@@@...w",
        "...e.e.e.e.@.e.@.e.e.e.e.e.@.e.e.@.e.e.@.e.@.e.e.@e@.....@e@.....e@@e@................e..........e....",
        "...e.@.e.e.e.e.e.e.e.e.e.e.e.e.e.e.e.e.e.e.e.@.e.....@e@......@e@......@e@@e@@e@@e@@e@@@e@@e@@@e@@@...",
        "w..@.e.@.@.e.@.e.@.@.@.@.@.e.@.@.e.@.@.e.@.e.e.@.@@e@.....@e@......@@e@......................e....e..w",
        "...e.e.e.e.@.e.@.e.e.e.e.e.@.e.e.@.e.e.@.e.@.e.e.e....@e@......@e@.e....@e@@e@@e@@e@@e@@e@@e@@@e@@e@..",
        "...e.@.e.e.e.e.e.e.e.e.@.e.e.e.e.e.e.e.e.e.e.@.e.e@@e@.....@e@.....@@@e@..............................",
        "w..@.e.@.@.e.@.e.@.@.@.e.@.e.@.@.e.@.@.e.@.e.e.@.e.....@e@@....e@@..e.....@e@@e@@e@@e@@e@@e@@e@@e@@@.w",
        "...e.e.e.e.@.e.@.e.e.e.e.e.@.e.e.@.e.e.@.e.@.e.e.@.@@e@...e..@@e.e..@@@e@.........................ee..",
        "...e.@.e.e.e.e.e.e.e.e.@.e.e.e.e.e.e.e.e.e.e.@.e.e.e......@@@e...@@e.e.....@.e.e.e.e.e@e.e.@.e@...@@..",
        "w..@.e.@.@.e.@.e.@.@.@.e.@.e.@.@.e.@.@.e.@.e.@.@.e.e..@e@..e.e@@.....@...e@e.@.@.@.@.e.e@@.e.@.e.e...w",
        "...e.e.e.e.@.e.@.e.e.e.e.e.@.e.e.@.e.e.@.e.@.e.e.@.@.......@@@.e.@e@..ee.e@e.e.e.e.e.@.e.e.e.e.@.@.@..",
        "...e.@.e.e.e.e.e.e.e.e.@.e.e.@.e.e.e.e.e.e.e.e@e.e.e...@e@..e..@@...e@@@.....@.e.e.e.e.@.@.@.e.e.e.e..",
        "w..@.e.@.@.@.@.e.@.@.@.e.@.e.e.@.e.@.@.e.@.e.e.e@e..........@@@.ee@@@.....e@.e.@.@.@.e.e.e.e.@.e@e.@.w",
        "...e.e.e.e.e.e.@.e.e.@.e.e.@.e.e.@.e.e.@.e.@.@.e.e@@@e.@@e@..ee@@@.e...@e@.....e.e.e.@.e.e.e.e.e.e.e..",
        "...e.@.e.e.e.e.e.e.e.e.@.e.e.@.e.e.e.e.e.e.e.e.@...e...e.....@@....@@@.....@e@@e.e.e.e.@.@.@.e.@.@....",
        "w..@.e.@.@.@.@.e.@.@.e.e.@.e.e.@.e.@.@.e.@.e.e.e.e@@@e@@@@e@....@e@.ee.@@e@......@.@.e.e.e.e.@.e.e.@.w",
        "...@.e.e.e.e.e.@.e.e.@.e.e.@.e.e.@.e.e.@.e.@.@..........e.....@.....@@@e....@e@@ee.e.@.e.@.e.e.e...e..",
        "...e.@.e.e.e.e.e.@.e.e.@.e.e.@.e.e.@.e.e.@.e.e.@e@@e@@e@@@@e@.e..@e@...@@e@@.....e@@.e.@.e.@.e.@.@@@..",
        "w..e.e.@.@.@.@.e.e.@.e.e.@.e.e.@.e.e.@.e.e.@.............e....@@....e@@....ee@@e@..e.e.e.e.e.@...ee..w",
        "...@.e.e.e.e.e.@.e.e.@.e.e.@.e.e.@.e.e.@.e.e.@e@@e@@e@@e@@@e@@.e.@@@..e.@@@@@......e.@.e.@.e.e.@e@@@..",
        "...e.@.e.e.e.e.e.@.e.e.@.e.e.@.e.e.@.e.e.@...................e.@@eee.@@@eee...e@@e.@.e.@.e.@.......e..",
        "w..e.e.@.@.@.@.e.e.@.e.e.@.e.e.@.e.e.@.e.e.@e@@e@@e@@e@@e@@e@@@..@@@@e...@@@e@.....e.e.e.e.e.@e@@e@@.w",
        "...@.e.e.e.e.e.@.e.e.@.e.e.@.e.e.@.e.e.@......................e......e@@.......@e@@e.@.e.@............",
        "...e.@.e.e.@.e.e.@.e.e.@.e.e.@.e.e.@.e.e.@e@@e@@e@@e@@e@@e@@e@@@e@@e@@.e.@e@@e@......e.@.e.@e@@e@@e@..",
        "w..e.e.@.@.e.@.e.e.@.e.e.@.e.e.@.e.e.@.................................@.......e@@e@@e.e.............w",
        "...@.e.e.e.e.e.@.e.e.@.e.e.@.e.e.@.e.e.@e@@e@@e@@e@@@@e@@e@@e@@e@@e@@e@..@e@@e@@.......e@@e@e@@e@@e@..",
        "...e.@.e.e.@.e.e.@.e.e.@.e.e.@.e.e.@...............ee..................e.........@e@@e................",
        "w..e.e.@.@.e.@.e.e.@.e.e.@.e.e.@.e.e.@e@@e@@e@@e@@e@@@e@@e@@e@@e@@e@@e@@.e@@e@@e@.....e.@e@@e@@e@@e@.w",
        "...@.e.e.e.e.e.@.e.e.@.e.e.@.e.e.@.................................................@e@@...............",
        "...e.@.e.e.@.e.e.@.e.e.@.e.e.@.e.e.@e@@e@@e@@e@@e@@e@@e@@e@@e@@e@@e@@e@@e@@e@@e@@e@.....@e@@e@@e@@e@..",
        "w..e.e.@.@.e.@.e.e.@.e.e.@.e.e.@....................................................@e@..............w",
        "...@.e.e.e.e.e.@.e.e.@.e.e.@.e.e.@e@@e@@e@@e@@e@@e@@e@@e@@e@@e@@e@@e@@e@@e@@e@@e@@e@...@@e@@e@@e@@e@..",
        "...e.@.e.e.@.e.e.@.e.e.@.e.e.@......................e...............................e..e..............",
        "w..e.e.@.@.e.@.e.e.@.e.e.@.e.e.@e@@e@@e@@e@@e@@e@@e@@@e@@@e@@e@@e@@e@@e@@e@@e@@e@@e@@..@@e@@e@@e@@e@.w",
        "...@.e.e.e.e.e.@.e.e.@.e.e.@............................e.............................................",
        "...e.@.e.@.@.e.e.@.e.e.@.e.e.@e@@e@@e@@e@@e@@e@@e@@e@@e@@@@e@@@e@@e@@@e@@e@@e@@e@@e@@e@@e@@@e@@e@@e@..",
        "w..e.e.@.e.e.@.e.e.@.e.e.@...............................e...e......e.....................e..........w",
        "...@.e.e.e.e.e.@.e.e.@.e.e.@e@@e@@e@@e@@e@@e@@e@@e@@e@@e@@@e@@@e@@e@@@e@@e@@e@@e@@e@@e@@e@@@e@@e@@e@..",
        "...e.@.e.@.@.e.e.@.e.e.@..............................................................................",
        "w..e.e.@.e.e.@.e.e.@.e.e.@e@@e@@e@@e@@e@@e@@e@@e@@e@@e@@e@@e@@e@@e@@e@@e@@e@@e@@e@@e@@e@@e@@e@@e@@e@.w",
        "...@.e.e.e.e.e.@.e.e.@................................................................................",
        "...e.@.e.@.@.e.e.@.e.e.@e@@e@@e@@e@@e@@e@@e@@e@@e@@e@@e@@e@@@e@@e@@e@@e@@e@@e@@e@@e@@@e@@e@@e@@e@@e@..",
        "w..e.e.@.e.e.@.e.e.@.......................................e........................e................w",
        "...@.e.e.e.e.e.@.e.e.@@@e@@e@@e@@e@@e@@e@@e@@e@@e@@e@@e@@e@@@e@@e@@e@@e@@e@@e@@e@@e@@@e@@e@@e@@e@@e@..",
        "...e.@.e.@.@.e.e.@...ee...............................................................................",
        "w..e.e.@.e.e.@.e.e.@e@@@@e@@@e@@e@@e@@e@@e@@e@@e@@e@@e@@e@@e@@e@@e@@e@@e@@e@@e@@e@@e@@e@@e@@e@@e@@e@.w",
        "...@.e.e.e.e.e.@.......e.e.e..........................................................................",
        "...e.@.e.@.@.e.e.@e@@e@@@@@@@e@@e@@e@@e@@e@@e@@e@@e@@e@@e@@e@@e@@e@@e@@e@@e@@e@@e@@e@@e@@e@@e@@e@@e@..",
        "w..e.e.@.e.e.@..........e.e..........................................................................w",
        "...@.e.e.e.e.e.@e@@e@@e@@@@@e@@e@@e@@e@@e@@e@@e@@e@@@e@@e@@e@@e@@e@@e@@e@@e@@e@@e@@e@@e@@e@@e@@e@@e@..",
        "...e.@.e.@.@.............e.........................e..................................................",
        "w..e.e.@.e.e.@e@@e@@e@@e@@@@e@@e@@e@@e@@e@@e@@e@@e@@@e@@e@@e@@e@@e@@e@@e@@e@@e@@e@@e@@e@@e@@e@@e@@e@.w",
        "...@.e.e.@................e...........................................................................",
        "...e.@.e.e.@e@@e@@e@@e@@e@@@e@@e@@e@@e@@e@@e@@e@@e@@e@@e@@e@@e@@@e@@e@@e@@e@@e@@e@@e@@e@@e@@e@@e@@e@..",
        "w..e.e.@.......................................................e.....................................w",
        "...@.e.e.@e@@e@@e@@e@@e@@e@@e@@e@@e@@e@@e@@e@@e@@e@@e@@e@@e@@e@@@e@@e@@e@@e@@e@@e@@e@@e@@e@@e@@e@@e@..",
        "...e.@................................................................................................",
        "w..e.e.@e@@e@@e@@e@@e@@e@@e@@e@@e@@e@@e@@e@@e@@e@@e@@e@@e@@e@@e@@e@@e@@e@@e@@e@@e@@e@@e@@e@@e@@e@@e@.w",
        "...@..................................................................................................",
        "...e.@e@e@@e@@e@@e@@e@@e@@e@@e@@e@@e@@e@@e@@e@@e@@e@@e@@e@@e@@e@@e@@e@@e@@e@@e@@e@@e@@e@@e@@e@@e@@e@..",
        "......................................................................................................"
    ]
}