{
    "name": "kiva_xxlarge_cma-mae_global_opt_repaired_one_endpt",
    "weight": false,
    "n_row": 101,
    "n_col": 102,
    "n_endpoint": 40,
    "n_agent_loc": 40,
    "maxtime": 5000,
    "layout": [
        "..e@@@@@@@@@@@@@e@@@@@@@@@@@@@@@@@@@@@@@@@@@@@@@@@@@@@@@@@@@@@@@@@@@@@@@@@@@@@@@@@@@@@@@@@@@@@@@@@@@..",
        "w.e@eeeeeeeeeee...eeeeeeeeeeeeeeeeeeeeeeeeeeeeeeeeeeeeeeeeeeeeeeeeeeeeeeeeeeeeeeeeeeeeeeeeeeeeeeeeee.w",
        "..e@@@@@@@@@@@@@@@@@@@@@@@@@@@@@@@@@@@@@@@@@@@@@@@@@@@@@@@@@@@@@@@@@@@@@@@@@@@@@@@@@@@@@@@@@@@@@@@@@..",
        "..e@@e.....e.e.eee.......ee................e@e...e.........@e......@e.......e.......e...e...e.........",
        "w.e@@@@@e@@@@@@@@@@@e@@@@@@.@e@.@.@@@.@@@.@@@@@e@@@ee@@@.@.@@@.@@@.@@@.@@@.@@@.@@@.@@@.@@@.@@@.@@@.@.w",
        "..e@e.e.e.e.e.e@e.e.e.eee..e@.e.e.eee.eee.e.e....@@eeeee.e.e.e.eee.e.e.eee.e.e.eee.e@e.e.e.e@e.eee.e..",
        "..e@@.@.@.@.@.@.@.@.@.@@@.@.@.@.@.@.@.@.@.@.@.@.@eee@@.@.@.@.@.@.@.@.@.@.@.@.@.@.@.@.@.@.@.@.@.@.@.@..",
        "w.@.e.e.e.e.e.e.e.e.e.e@e.e.e.e.e.e.e.e.e.e.e.e.eeee@e.e.e.e.e@e.e.e.e.e.e.e.e.e.e.e.e.e.e.e.e.e.e.e.w",
        "..e.@.@.@.@.@.@.@.@.@.@.@.@.@.@.@.@.@.@.@.@.@.@.@@@@e@.@.@.@.@.@.@.@.@.@.@.@.@.@.@.@.@.@.@.@.@.@.@.@..",
        "..e@e.e.e.e.e.e.e.e.e.e.e.e.e.e.e.e.e.e.e.e.e.e.ee@eee.e.e.e.e.e@e.e.e.e.e.e.e.e.e.e.e.e.e.e.e.e.e.e..",
        "w.e@@.@.@.@.@.@.@.@.@.@.@.@.@.@.@.@.@.@.@.@.@.@.@eee@@.@.@.@.@.@.@.@.@.@.@.@.@.@.@.@.@.@.@.@.@.@.@.@.w",
        "..e.e.e.e.e.e.e.e.e.e.e.e.e.e.e.e.e.e.e.e.e.e.e.ee@eee.e.e.e@e.e.e.e.e.e.e.e.e.e.e.e.e.e.e.e.e.e.e.e..",
        "..@.@.@.@.@.@.@.@.@.@.@.@.@.@.e@e.@...@.@.@.@.@.@eeee@.@.@.@.@.@.@.@.@.@.@.@.@.@.@.@.@.@.@.@.@.@.@.@..",
        "w.e.e.e.e.e.e.e.e.e.e.e.e.e.e.e.e...e.e.e.e.e.e.ee@@ee.e.e.e.e.e@e.e.e.e.e.e.e.e.e.e.e.e.e.e.e.e.e.e.w",
        "..e.@.@.@.@.@.@.@.@.@.@.@.@.@.@.@.@.@.@.@.@.@.@.@eeee@.@.@.@.@.@.@.@.@.@.@.@.@.@.@.@.@.@.@.@.@.@.@.@..",
        "..@@e.e.e.e.e.e.e.e.e.e.e.e.e.e.e.e.e.e.e.e.e.e.eeee@e.e.e.e.e.e.e.e.e.e.e.e.e.e.e.e.e.e.e.e.e.e.e.e..",
        "w.e.e@e.@.@.@.@.@.@.@.@.@.@.@.@.@.@.@.@.@.@.@.@.@@@ee@.@.@.@.@.@.@.@.@.@.@.@.@.@.@.@.@.@.@.@.@.@.@.@.w",
        "..e@.@e@@@e.e.e.e.e.e.e.e.e.e.e.e.e.e.e.e.e.e.e.eeee@e.e.e.e.e.e.e.e.e.e.e.e.e.e.e.e.e.e.e.e.e.e.e.e..",
        "..@@@@@@e@.e@.@...@.@.@e@.@.@.@.@.@.@.@.@.@.@.@.@e@ee@.@.@.@.@.@.@.@.@.@.@.@.@.@.@.@.@.@.@.@.@.@.@.@..",
        "w..eee.e.e@.e.e@...@...@.e..e.e.e.e.e.e.e.e.e.e.eeeee@.e.e.e.e.e.e.e.e.e.e.e.e.e.e.e.e.e.e.e.e.e.e.e.w",
        "...@.e......@.e...ee.e@@e@e@e@@.@.@.@.@.@.@.@.@.@@e@ee.@.@.@.@.@.@.@.@.@.@.@.@.@.@.@.@.@.@.@.@.@.@.@..",
        "..ee@@@e@@@e@@@@e@@.........e.e.e.e.e.e.e.e.e.e.ee@e@e.e.e.e.e@e.e.e.e.e.e.e.e.e.e.e.e.e.e.e.e.e.e.e..",
        "w.@.e....e...e.e@.......e@@.@.@.@.@.@.@.@.@.@.@.@@eeee.@.@.@.@.@.@.@.@.@.@.@.@.@.@.@.@.@.@.@.@.@.@.@.w",
        "..@@@@e@@@@@@@@@@.@.@e@.e.e@e.e@e.e.e.e.e.e.e.e.eee@e@.e.e.e.e.e.e.e.e.e.e.e.e.e.e.e.e.e.e.e.e.e.e.e..",
        "..eee@e.e.eee.e@e.e.e.@.@.@.@.@.@.@.@.@.@.@.@.@.@eeeee.@.@.@.@.@.@.@.@.@.@.@.@.@.@.@.@.@.@.@.@.@.@.@..",
        "w.e.e.e.e.e.e@e.e.e.e.e.e.e.e.e.e.e.e.e.e.e.e.e.ee@e@e.e.e.e.e.e.e.e.e.e.e.e.e.e.e.e.e.e.e.e.e.e.e.e.w",
        "..@.@.@.@.@..e@.@.@.@.@.@.@.@.@.@.@.@.@.@.@.@.@.@eee@e.@.@.@.@.@.@.@.@.@.@.@.@.@.@.@.@.@.@.@.@.@.@.@..",
        "..e.e.e.e.e.e.ee.e@.e.e.e.e.e.e.e.e.e.e.e.e.e.e.@ee@ee.e.e.e@e.e.e.e.e.e.e.e.e.e.e.e.e.e.e.e.e.e.e.e..",
        "w.e@.@e.@e@.@.e@e@e.e@@.@.@.@.@.@.@.@.@.@.@.@.@.@ee@e@.@.@.@.@.@.@.@.@.@.@.@.@.@.@.@.@.@.@.@.@.@.@.@.w",
        "..ee@@.@..........@.@.e.e.e.e.e.e.e.e.e.e.e.e.e.eee@@e.e.e.e.e.e.e.e.e.e.e.e.e.e.e.e.e.e.e.e.e.e.e.e..",
        "..@@@e@e@.....e.e.e.@.@.@.@.@.@.@.@.@.@.@.@.@.@.@@e@ee.@.@.@.@.@.@.@.@.@.@.@.@.@.@.@.@.@.@.@.@.@.@.@..",
        "w.@.@.@.@.@.@.@.@.e.e.e.e.e.e.e.e.e.e.e.e.e.e.e.eeeee@.e.e.e.e.e.e.e.e.e.e.e.e.e.e.e.e.e.e.e.e.e.e.e.w",
        "..e.e.e.e.e.e.e.@.@.@.@.@.@.@.@.@.@.@.@.@.@.@.@.@e@@ee.@.@.@.@.@.@.@.@.@.@.@.@.@.@.@.@.@.@.@.@.@.@.@..",
        "..e.@.@.@.e.e.e.e.e.e.e.e.e.e.e.e.e.e.e.e.e.e.e.ee@@ee.e.e.e.e.e.e.e.e.e.e.e.e.e.e.e.e.e.e.e.e.e.e.e..",
        "w.@.e.e.e.@.@.@.@.@.@.@.@.@.@.@.@.@.@.@.@.@.@.@.@eeee@e@.@.@.@.@.@.@.@.@.@.@.@.@.@.@.@.@.@.@.@.@.@.@.w",
        "....@..@.e@.e.e.e.e.e.e.e.e.e.e.e.e.e.e.e.e.e.e.ee@eeee@@e.e.e.e.e.e.e.e.e@e.e.e.e.e.e.e.e.e.e.e.e.e..",
        "..e@@.eee@e.e@@.@.@.@.@.@.@.@.@.@.@.@.@.@.@.@.@.@eee@ee@e@.@.@.@.@.@.@.@.@.@.@.@.@.@.@.@.@.@.@.@.@.@..",
        "w...e.@...@.@.e.e.e.e.e.e.e.e.e.e.e.e.e.e.e.e.e.e@eee@eeee.e.e.e.e.e.e.e.e.e.e.e.e.e.e.e.e.e.e.e.e.e.w",
        "...@e.e.e.e.@.@.@.@.@.@.@.@.@.@.@.@.@.@.@.e.e.e.eee@eeee@eee@@.@.@.@.@.@.@.@.@.@.@.@.@.@.@.@.@.@.@.@..",
        "...e@.@.@.e.e.e.e.e.e.e.e.e.e.e.e.e.e.e.@.@.@.@.@eeeee@eee@e@e.e.e.e.e.e.e.e.e.e.e.e.e.e.e.e.e.e.e.e..",
        "w.@@@.e.@.@.@.@.@.@.@.@.@.@.@.e.@.e.e.e.e.e.e.e.ee@e@eee@eee@@.@.@.@.@@@.@.@.@.e.e.e.e.e.@.@.@.@.@.@.w",
        "..e.e.e.e.e.e.e.e.e.e.e.e.e.@.@.@.@.@.@.@.@.@.@.@@eeee@eeeeee@@e@.@...ee@@ee@@.@.@.@.@.@...@.e.e.e.e..",
        "..@.@.@.@.@.@.@.@.e.@.e.e.e.e.e.e.e.e.e.e.e.e.e.ee@@@eeee@@@e.e.e.e.e.@@@.@.ee.e@.......@e.e.@.@.@.@..",
        "w.e.e.e.e.e.e.e.e.@.@.@.@.@.@.@.@.@.@.@.@.@.@.@.@eeeeee@@ee...@.@.@.@...e.@.@...e.e.e.e.e....e.e.e.e.w",
        "...@e@@.@.@.@.@.e.e.e.e.e.e.e.e.e.e.e.e.e.e.e.e.e@eee@e@e.e.e.e.e.e.e.e.e.ee@@@e@.@.@.@.@....@.@.@.@..",
        "....e.e.e.e.e.e.@.@.@.@.@.@.@.@.@.@.@.@.@.@.@.@.@ee@@.....@.@.@.@.@.@.@e@.e.@e.@...............e.@.e..",
        "w.@.@.e@@.@.@.e.e.e.e.e.e.e.e.e.e.e.e.e.e.e.e.e.e.e.e.e.e.e.e.e.e..@.@...e@.@e.................e.e.@.w",
        "..e.e.e.e.e.@.@.@.@.@.@.@.@.@.@.@.@.@.@.@.@.@.@.@.@.@.@.@.@.@.@.@..e.e@e.@.@...................@...e..",
        "..e.e.@.@.e.e.e.e.e.e.e.e.e.e.e.e.e.e.e.e.e.e........................@....ee@......................@..",
        "w.@.@.e.e.@.e.e.e.e.e.e.e.e.e.@.@.@.@.@.@.@.@e@.@.@.@e@.@.@e@.@.@e@.@.@e@.@.ee@...................e@.w",
        "..@.e.@.@.@.@.@.@.@.@.@.@.@.@.e.e.e.e.e.e.e.e...e.e@.@.@e@.@.@e@.@.@e..@.@e@....@................e@@..",
        "..e.@.e.e.e.e.e.e.e.e.e.e.e.e.@.@.@.@.@.@.@.@..@e@.@e@.@e@.@e@.@e@.@e@.@e@.@e@.@e@.@.@e@.@.@..e@@..e..",
        "w.e@e.e.e.e.e.e.e.e.e.e.e.e.e.e.e.e.e.e.e.e.@e@.................................e.@ee..@.e@e@.@@e..@.w",
        "..e.@.@.@.@.@.@.@.@.@.@.@.@.@.@.@.@.@.@.@.@.@.@e................................@.@@@e@e@@@.@.@.@..e..",
        "..@.e.e.e.e.e.e.e.e.e.e.e.e.e.e.e.e.e.e.e.e.e...................................e.e.@.....e.e.e.......",
        "w.@.@.@.@.@.@.@.@.@.@.@.@.@.@.@.@.@.@.@.@.@.@e@.@.@e@.@e@.@e@.@e@.@e@e@.@e@.@e@.@.e.e.e.e.@.@.@.@e@@.w",
        "..e.e.e.e.e@e.e.e.e.e.e.e.e.e.e.e.e.e.e.e.ee@...e.................................@.@.@.@..........e..",
        "..e.@.@.@.@.@.@.@.@.@.@.@.@.@.@.@.@.@.@.@.@.@e........................................................",
        "w.@.e.e.e.e.e.e.e.e.e.e.e.e.e.e.e.e.e.e..ee........................................................e.w",
        "..e.@.@.@.@.@.@.@.@.@.@.@.@.@.@.@.@.@.@e.@.........................................................@..",
        "..@.e.e.e.e.e.e.e.e.e.e.e.e.e.e.e.e.e.e.@........................................................e.@..",
        "w.e.@.@.@.@.@.@.@.@.@.@.@.@.@.@.@.@.@.e.e........................................................@.e.w",
        "..e.e.e.e.e.e.e.e.e.e.e.e.e.e.e.e.e.e.@.@......................................................@@e.@..",
        "..@.@.@.@.@.@.@.@.@.@.@.@.@.@.@.@.@.e.e.e......................................................e@e.@..",
        "w.e.e.e.e.e.e.e.e.e.e.e.e.e.e.e.e.e.@.@......................................................@.e.@.e.w",
        "..e@e.e.@.@.@.@.@.@.@.@.@.@.@.@.@.e.e.e.e..................................................@.e.@.e.@..",
        "..e.@.@.e.e.e.e.e.e.e.e.e.e.e.e.@.@.@.@.@.@@..............................................@e.e.e.@.@..",
        "w.@.e.e.e.e.e.e.e.e.e.e.@.e.e.e.e.e.e.e.e.ee..............................................@e.@@e.e.e.w",
        "..e.@.@.@.@.@.@.@.@.@.@.@.@.@.@.@.@.@.@.@.@.@@...........................................@.e.e@e.e.@..",
        "..e.e.e.e.e.e.e.e.e.e.e.e.e.e.e.e.e.e.e.e.e.ee...........................................e@@.e@e.@.@..",
        "w.@.@.@.@.@.@.@.@.@.@.@.@.@.@.@.@.@.@.@.@.@.@..........................................@.@.e.e@e.e.e.w",
        "..@.e.e.e.e.e.e.e.e.e.e.e.e.e.e.e.e.e.e.e.e.e........................................@.e@e.@@e@e.@.@..",
        "..e.@.@.@.@.@.@.@.@.@.@.@.@.@.@.@.@.@.@.@.@.@.@......................................e.e.e@@.e@e.e.@..",
        "w.@.e.e.e.e.e.e.e.e.e.e.e.e.e.e.e.e.e.e.e.e.e.e@....................................@e.@.e@e.e@e@e.e.w",
        "..e.@.@.@.@.@.@.@.@.@.@.@.@.@.@.@.@.@.@.@.@.@.@....................................e@e.e.@.e.e.@@e@@..",
        "..e@e.e.e.e.e.e.e.e.e.e.e.e.e.e.e.e.e.e.e.e.e.e@e..............................@...@@e.e.e.@.@.@@e.@..",
        "w.e.@.@.@.@.@.@.@.@.@.@.@.@.@.@.@.@.@.@.@.@.@.@.@@...........................e.e.@.e.e@@.@.e@e.e.@.e.w",
        "..@.e.e.e.e.e.e.e.e.e.e.e.e.e.e.e.e.e.e.e.e.e.e.eee@.......................@.@.@.e.e@e.e@e@e.e@e.e@@..",
        "..e.@.@.@.@.@.@.@.@.@.@.@.@.@.@.@.@.@.@.@.@.@.@.@eee@......................e.e.e.e@e.e.e@e.e.e@e.e@@..",
        "w.e.e.e.e.e.e.e.e.e.e.e.e.e.e.e.e.e.e.e.e.e.e.e.ee@e@@e@...............@.@.@.@.e@e.@.@.e.e.@@e.e.@.e.w",
        "..@.@.@.@.@.@.@.@.@.@.@.@.@.@.@.@.@.@.@.@.@.@.@.@eeeeee@@............e.e.e.e.e@e@e.e.e.@.@.@.@.@.@.@..",
        "..e.e.e.e.e.e.e.e.e.e.e.e.e.e.e.e.e.e.e.e.e.e.e.eee@eeeee@e@.........@.@.@.@@e.e@e@e@@.e.e.e.e.@@e.@..",
        "w.e.@.@.@.@.@.@.@.@.@.@.@.@.@.@.@.@.@.@.@.@.@.@.@@@@e@@e@eee@........e.e.e.e.@.e.@@e.e.e@e@e@e.e@e.e.w",
        "..@.e.e.e.e.e.e.e.e.e.e.e.e.e.e.e.e.e.e.e.e.e.e.eeeee@e@ee@ee@e@.....@...e@e.e.@.@.@.e@e.e.e@e.e@e@@..",
        "..e.@.@.@.@.@.@.@.@.@.@.@.@.@.@.@.@.@.@.@.@.@.@.@eee@eeeeeeeeeee@@@..e@e.e@e.@.e.e.e@e.e.@.e@e@e.e.@..",
        "w.@.e.e.e.e.e.e.e.e.e.e.e.e.e.e.e.e.e.e.e.e.e.e.ee@eee@e@@e@@e@e@ee@ee@@.e.@.@.@.@.@.e.@.e.e@e@@.@.e.w",
        "..e.@.@.@.@.@.@.@.@.@.@.@.@.@.@.@.@.@.@.@.@.@.@.@eee@eeeeeeee@eeee@e@e.e.@.@@e.e.e.e.@.e.@@e.e.@.@.@..",
        "..@.e.e.e.e.e.e.e.e.e.e.e.e.e.e.e.e.e.e.e.e.e.e.eee@eee@ee@@eee@eeeee@e@.@.e@e.e.e@e.e.e.e.e.@.e.e.@..",
        "w.e@@.@.@.@.@.@.@.@.@.@.@.@.@.@.@.@.@.@.@.@.@.@.@@eee@e@eeeeeee@e@e@e@eeee.@.e.@.@.e.@.@@e.@.e.e.e@e.w",
        "..e.e.e.e.e.e.e.e.e.e.e.e.e.e.e.e.e.e.e.e.e.e.e.ee@e@eeee@ee@@eeee@e@eee@eeee@ee.@.@.e.e.e@e.e@@.e.@..",
        "..@.@.@.@.@.@.@.@.@.@.@.@.@.@.@.@.@.@.@.@.@.@.@.@eeeee@ee@@eeeee@e@eee@eee@ee@@e@e.e.e@e.@@e.e@@.@.@..",
        "w.e.e.e.e.e.e.e.e.e.e.e.e.e.e.e.e.e.e.e.e.e.e.e.eee@ee@eeeee@e@e@@eee@@@@eeee@@@.......@e.ee@e.e.e.e.w",
        "..e@e.@.@.@.@.@.@.@.@.@.@.@.@.@.@.@.@.@.@.@.@.@.@@eee@ee@e@eeeeeee@@e@ee@e@@eee@@e@@@e@@@e.@@e.@@e.@..",
        "...@e@.e@@e.e.e.e.e.e.e.e.e.e.e.e.e.e.e.e.e.e.e.eee@ee@eeeeee@@@e@@e@@e.e.e.e.ee...e...ee@e.@.@@@e@...",
        "w.eeeee@eeee@.@.@.@.@.@...@.@.@.@.@.@.@.@.@.@.@.@ee@eeeee@@@eeeee@ee@.@.@.@.@.@@@.@@@.@@@..@e.ee@@@..w",
        "..@.@...@.@...............e.e.e.e.e.e.e.e.e.e.e.ee@ee@e@ee@eeee@@ee.e.e.e.e.e.e.e.e.e.e@e.e@@@@..@e...",
        "..e.@@e.e..................@ee@.e@e.@.@.@.@.@.@.@eee@@eeeeee@@eee.@.@.@.@.@.@.@.@e..@.@....e.e.e.@@@..",
        "w.e.e.e@e...............ee@.e.e@e@.ee.e.e.e.e.e.ee@eeee@@@eeeeee@..@e@.e@@eee@.e.@.@.@.@.@.@.@.@.e@e.w",
        "..@.@.@.@e@.............@@..@e@e.@e@e@@.@.@e@ee@@eeee@eeeee@ee@ee@e@e@@@@@@@@@@@@@.e.e.e.e.e.e.e.e@@..",
        "......e.e..............@.....@e..e..........e......@.........@..@.....eeee...eeeee...@.@...@..........",
        "..e@e.e@@.@e@..e@..e@..e.e@e@@e@..e@@e@e@.@e@e@e@@e@@e@@e@@e@@e@@e@@e@@@@@@e@@@@@@@e@@e@@e@@e@@e@@e@.."
    ]
}