{
    "name": "kiva_xxlarge_cma-mae_global_opt_repaired",
    "weight": false,
    "n_row": 101,
    "n_col": 102,
    "n_endpoint": 40,
    "n_agent_loc": 40,
    "maxtime": 5000,
    "layout": [
        "..@e@e@e@e@e@e.....e@e@e...................................................................@e@e@e@....",
        "w.e...........ee@ee@e...e@ee@e@e@e@e@e@e@e@e@e@e@e@e@e@e@e@e@e@e@e@e@e@e@e@e@e@e@e@e@e@e@e@e.....e.e.w",
        "..@e@e@e@e@e@e@@e.....@e@@e........................@...................e...........ee.......e@e@e@e@..",
        "..................e@e@e..ee@e@e@eee@eeeee...eee@eeeeeeeee@e@ee@@e@e@e@e@@e@e@e@e@e.@..ee@e@e@.........",
        "w.@e@e@e@e@e@e@e@e@.@.e@e@@.....e@e@e@@@@e@e@@e@e@@e@@@@e@@e@@ee........e..........e@e@@e....e@e@e@e.w",
        "..e.................ee@.e.e.e@@e......ee.............ee..e......eee@e@e@e@e@e@e@e@e@......e@e@..e.....",
        "..@e@e@e@ee@e@e@e@e@e@e@@e@e@eee@e@e@e@@e@e@e@e@e@e@e@e@@e@e@e@e@@e..................e@e@e@...@e@@e@..",
        "w......................e......e...............e........ee..........e@e@e@e@e@e@e@e@e@@....e@e@e..e.e.w",
        "..@e@e@e@e@e@@e@e@e@e@e@e@e@ee@e@e@e@e@e@e@e@e@@e@e@e@e@e@e@e@e@eee.................ee.e@e@....ee@e@..",
        "..e.........ee.................................e...............ee@@e@e@e@e@e@e@e@e@e@e@e...e@e@@e.....",
        "w.@e@e@e@e@e@...@e@e@e@e@e@e@e@e@e@e@e@e@e@e@e@e@e@e@e@e@e@e@ee.............e...........e@e@..e...e@.w",
        "..............e@e...........................................e@@e@e@e@e@e@e@e.ee..e@@e@ee@...e@e@e@@e..",
        "..@e@e@e@e@ee@e@e@e@e@@ee@e@e@e@e@e@e@e@e@e@e@e@e@e@e@e@e@.e...............@e@@@e@ee......ee.ee..e....",
        "w.e..................ee@.................................e@@e@e@e@e@e@e@e@e...ee...@e@ee@e@@e@@e@@e..w",
        "..@e@e@e@e@.e@e@e@e@e@....@e@e@e@e@e@e@e@e@e@e@e@e@e@e@.e.e...............@e@e@e@...............e.....",
        "..........e............@e@e..............e............e@@.@e@e@e@e@e@e@e@.......e@e@ee@ee@e@e@e@e@e@..",
        "w.@e@e@e@e@e@@e@e@ee@e@e..e@e@e@e@e@e@e@e@@e@e@e@e@@ee.ee...............ee@e@e@e@.....e@@e.......e.e.w",
        "..e.........eee.......e@ee@...............e.......ee@@e@@e@e@e@e@e@e@e@e@.........eee......e@e@e@@e@..",
        "..@e@e@e@e@e@.@ee@ee@e@@eee@e@e@e@e@ee@e@e@e@e@e@e@......................e@e@e@e@e@@@ee@e@e@....e.....",
        "w.............e@@@e....ee@@e........................e@e@e@e@e@e@e@e@e@e@ee.........e........eee@eeee.w",
        "..e@e@e@e@e@e@..ee.eee@@@..@ee@e@e@e@e@e@e@e@e@e@e@e@....................@ee@e@e@e@e@e@e@e@e@@e@e@@@..",
        ".............ee@e@e@@@eee.ee.............e............e@e@e@e@e@e@e@e@@e@@e@......................ee..",
        "w.@e@e@e@e...@...ee@e..e@e@@e@e@e@e@e@e@e@@e@e@e@e@e@e@..............ee.ee...eeee@e@e@e@e@ee@e@e@e@@.w",
        "..e..........e..e@....e@..e...............e.............e@e@e@e@e@e@e@e@e@e@e@@@@e.................e..",
        "..@e@ee@e@e@.@......@ee@e@@e@e@e@e@e@e@e@e@e@e@e@e@e@e@e@..........e..........ee...eee@e@ee@e@e@e@e@..",
        "w...ee.....e.e.e.@e@e@@..e...e............e...............e@e@e@e@e@@e@e@e@e@e@@e@e@@@e...ee.........w",
        "..@e@@e@e@.@.@.@.e.e..e.e@ee@@e@e@e@e@e@e@@e@e@e@e@e@e@e@e@.........e...............e....e@@e@ee@e@e..",
        "..e......e.e.e.e.@.@e@e@@@e@e............e..................ee@e@e@e@e@e@e@e@e@e@e@e@ee@e@....e@......",
        "w.@e@e@e.@.@.@.@.e.@e..eee.....e@e@e@e@e@@e@e@e@e@ee@e@e@e@e@..............................e@....ee@.w",
        ".........e.e.e.e.@.ee@e@e@e@e@e@e.......e........e.@..........@e@e@e@e@e@e@e@e@e@e@e@e@e@e@@ee@e@@ee..",
        "..@e@.e@.@.@.@.@.e.@e.e...........e@e@e@e@e@e@e@...eee@ee@e@e@e...........................e..e..e.....",
        "w.e.e..e.e.e.e.e.@.ee@@e@e@e@e@e@e@............e@e@e@@e........e@e@e@e@e@e@e@e@e@e@e@e@e@e@e@@e@e@e@.w",
        "..@.@e.@.@.@.@.@.e.@ee..............e@e@e@e@e@e@.......ee@e@e@e@............................e......e..",
        "..e.ee.e.e.e.e.e.@.ee@e@@ee@e@e@ee@e@...........e@e@e@e@@........e@e@e@e@e@e@e@e@e@e@e@e@e@e@e@e@@e@..",
        "w.@e@@.@.@.@.@.@.e.@...eee.....e.....ee@@e@e@e@e@.......e.@ee@e@e@..............................ee...w",
        ".....e.e.e.e.e.e.e.e.....@.eee@@e@e@e@@ee.........@e@e@e@@e........e@e@e@e@e@e@e@e@e@e@e@e@e@e@e@e@e..",
        "..e..@.@.@.@.@.@.@e@e@e@eee@@@e..........e@ee@e@e@e..e...ee@e@e@e@e@..................................",
        "w.@..e.e.e.e.e.e.e..........e...eee@e@e@e@.........e@@e@e@..........e@e@e@e@e@e@e@e@e@e@e@e@e@e@e@e..w",
        "..e..@.@.@.@.@.@.@eeee@ee@eeee@e@@@e....ee.ee@e@e@e@e....e@e@e@e@e@e@.............................e...",
        "..@..e.e.e.e.e.e.@e@@@e@@ee@@@e..e....ee@@e@........e@e@e@..........e@e@e@e@e@e@e@e@@e@e@e@e@e@e@.@...",
        "w.e..@.@.@.@.@.@.e..e..e....e...eeee@e@.......e@e@e@e......e@e@e@e@e@...e..........ee...........e.e..w",
        "..@..e.e.e.e.e.e..ee@e@@@e@eee@e@@@@e...@e@e@e@......e@e@e...........e@e@@eee@e@ee....@eeee@ee@e@e....",
        "..e..@.@e@.e.@.@.e@...eee..e@....ee.ee@ee.......e@ee@e.e@ee@e@e@e@e@e....ee@e@e@e@e@e@e@@@@@e....@e...",
        "w.@..e.e.@e@.e.e....e..........ee@@e@@e..@e@ee@e@..e..e@@e@...........@ee@..............eeee......@..w",
        "..e..@.e.e.e.@.@.@e.@e@e@ee@e@e@........ee........e@@e@.e..e@e@@e@e@e@e...e@e@e@e@e@e@e@e@@e@e@e@ee...",
        "..@..e.@.@.@.e.e.e........e......e@e@e@e@@e@ee@e@e@.e..e@@e@..ee......@e@e@......................@e...",
        "w.e..@.e.e.e.@.@.@..eee@ee@@e@e@e@.................e@e@..e..e@e@@e@e@......e@e@e@e@e@e@e@e@e@e@..@e..w",
        "..@..e.@.@.@.e.e.e.e@@e@ee@e......e@e@e@e@e@e@e@e@e@..ee@@e....ee...ee@ee@e@..................e..e@...",
        "..e..@.e.e.e.@.@.e...........@eee.........e.........@e@@e...e@e@@e@e@........e@e@e@e@e@e@e@e@e@..@e...",
        "w.@..e.@.@.@.e.e.@e@e@e@e@e@@e@@@e@e@e@e@e@@e@e@e@e@e...e@e@.........e@ee@e@e@..................e@e..w",
        "..e..@.e.e.e.@.@e@.........ee..e...........e........@e@@e..ee@e@e@e@e@.....e...e@e@e@ee@e@e@@e@e.@e...",
        "..@..e.@.@.@.e.e.e..e@e@e@e@e@e@@eee@e@e@e@e@e@e@e@e..eee@e@...........eee@@e@e@.e.........ee....e@...",
        "w.e.e@.e.e.e.@.e.@e@@e..........e@@@e..............e@e@@.e..e@e@e@e@e@e@@@e......@e@e@e@e@........e..w",
        "..@e...@.@.@.e.@e@.e..e@e@e@eee...e...eeee@e@e@e@e.....e@@e@............e....ee@e..ee....e@e@ee@e@e...",
        "..@e@e@e.e.e.@.e.e.@e@@e..e@e@@e@e@e@e@@@@e.......e@@e@@e..e.@e@e@e@e@e@e@e@e@@e@@e@@e@e@....e...e@...",
        "w.ee@e...@.@.e.@.@e@.e..e..............ee....eeeee@ee.ee@@e@.e........e..........e.....ee@e@e@@e@@e..w",
        "..ee@e@e.e.e.@.e.e.e.e@.@e@@e@e@e@e@e@ee@@e@e@@@@e@e@e@@.e..e@e@e@e@ee@@e@e@e@e@e@@eee@@@..e..e.e@e...",
        "..@e.....@.@.e.@.@.@.@e.e.ee.............e....ee.......ee@e@@..........e..........e@@eeee@e@@e@...e...",
        "w.@e@e@e@e.e.@.e.e.e.........ee@e@e@e@e...ee@e@@e@e@e@e@@..ee.eee@e@ee@@e@@eeee@e...........e.e@@e@..w",
        "..ee.......@.e.@.@.@...e@e@e@@@e......e@@e@@e...@...@..@e@e@@e@@e....@e..ee@@@@e@ee@e@e@e@e@e..ee.....",
        "..@@e@e@e@.e.@.e.e.e........ee..eee@e.eee.....eeeee.e.eee.........ee........ee................@ee@e@..",
        "w.e...ee.e.@.e.@e@.@e@e@e@e@ee@e@@e@@e@@ee@e@e@@e@@e@e@.@e@e@e@e@e@@e@e@ee@e@@e@e@e@e@e@e@e@e@e....e.w",
        "..@e@e@@e@@e.@.....................e..........................................................eee@e@..",
        "..........e@.e@e@e@e@e@e@e@e@e@e@e@e@e@e@e@ee@e@e@e@e@e@e@e@e@e@e@e@e@e@ee@e@e@e@e@e@e@e@e@e@e@@@.....",
        "w.@e..ee@e@....................................................................................ee.e@.w",
        "..ee@e@...e@e@e@e@e@e@e@e@e@e@e@e@e@e@e@e@e@e@e@e@e@e@e@e@e@e@e@e@e@e@e@e@e@e@e@e@e@e@e@e@e@e@e@@e@e..",
        "..@e..................................................................................................",
        "w.....e@e@e@e@e@e@e@e@e@e@e@e@e@e@e@e@e@e@e@e@e@e@e@e@ee@ee@e@e@e@e@e@e@e@e@e@e@e@e@e@e@e@e@e@e@e@e@.w",
        "..e@...............................................................................................e..",
        "..@e@e@e@e@e@e@e@e@e@e@e@e@e@e@e@e@e@e@e@e@e@e@e@e@e@e@e@e@e@e@e@e@e@e@e@e@e@ee@e@e@e@e@e@e@e@e@e@e@..",
        "w...........................................e........................................................w",
        "..@e@e@e@e@e@e@e@e@e@e@e@e@e@e@e@e@e@e@e@e@e@@e@e@e@e@e@e@e@e@e@e@e@e@e@e@e@e@e@e@e@e@e@e@e@e@e@e@e@..",
        "..e..........................................e.....................................................e..",
        "w.@e@e@e@e@e@e@e@e@e@e@e@e@e@e@e@e@e@e@e@e@e@@e@e@e@e@e@e@e@e@e@e@e@e@e@e@e@e@e@e@e@e@e@e@e@e@e@e@e@.w",
        "............................................e.........................................................",
        "..@e@e@e@e@e@e@e@e@e@e@e@e@e@e@e@e@e@e@e@e@e@e@e@e@e@e@e@e@e@e@e@e@e@e@e@e@e@e@e@e@e@e@e@e@e@e@e@e@e..",
        "w.e..................................................................................................w",
        "..@e@e@e@e@e@e@e@e@e@e@ee@e@e@e@e@e@e@e@e@e@e@e@e@e@e@e@e@e@e@e@e@e@e@e@e@e@e@e@e@e@e@e@e@e@e@e@e@e@..",
        "...................................................................................................e..",
        "w.@e@e@e@e@e@e@e@e@e@e@ee@e@e@e@e@e@e@e@e@e@e@e@e@e@e@e@e@e@e@e@e@e@e@e@e@e@e@e@e@e@e@e@e@e@e@e@e@e@.w",
        "..e...................................................................................................",
        "..@e@e@e@e@e@e@e@e@e@e@e@e@e@e@e@e@e@e@e@e@e@e@e@ee@e@e@e@e@e@e@e@e@e@e@e@e@e@e@e@e@e@e@e@e@e@e@e@e@..",
        "w..................................................................................................e.w",
        "..@e@e@e@e@e@e@e@e@e@e@e@e@e@e@e@e@e@e@e@e@e@e@e@e@e@e@e@e@e@e@e@e@e@e@e@e@e@e@e@e@e@e@e@ee@e@e@e@e@..",
        "..e...................................................................................................",
        "w.@e@e@e@e@e@e@e@e@e@e@e@e@e@e@e@e@e@e@e@e@e@e@e@e@e@e@e@e@e@e@e@e@e@e@e@e@e@e@e@e@e@e@e@ee@e@e@e@e@.w",
        "...................................................................................................e..",
        "..e@e@e@e@e@e@e@e@e@e@e@e@e@e@e@e@e@e@e@e@e@e@e@e@e@e@e@e@e@e@e@e@e@e@e@e@e@e@e@e@e@e@e@e@e@e@e@e@e@..",
        "w...................................................................e................................w",
        "..@e@e@e@e@e@e@e@e@e@e@e@e@e@e@e@e@e@e@e@e@e@e@e@e@e@e@e@e@e@e@e@e@e@@e@e@e@e@e@e@e@e@e@e@e@e@e@e@e@..",
        "..e..................................................................e.............................e..",
        "w.@e@e@e@e@e@e@e@e@e@e@e@e@e@e@e@e@e@e@e@e@e@e@e@e@e@e@e@e@e@e@e@e@e@@e@e@e@e@e@e@e@e@e@e@e@e@e@e@e@.w",
        "................................................................e...e.................................",
        "..@e@e@e@e@e@e@e@e@e@e@e@e@e@e@e@e@e@e@e@e@e@e@e@e@e@e@e@e@e@e@e@@e@e@e@e@e@e@e@e@e@e@e@e@e@e@e@e@e@..",
        "w.e..............................................................e.................................e.w",
        "..@e@e@e@e@e@e@e@e@e@e@e@e@e@e@e@e@e@e@e@e@e@e@e@e@e@e@e@e@e@e@e@@e@e@e@e@e@e@e@e@e@e@e@e@e@e@e@e@e@..",
        "................................................................e.....................................",
        "w.@e@e@e@e@e@e@e@e@e@e@e@e@e@e@e@e@e@e@e@e@e@e@e@e@e@e@e@e@e@e@e@@e@e@e@e@e@e@e@e@e@e@e@e@e@e@e@e@e@.w",
        "..e.............................................................ee.................................e..",
        "..@e@e@e@e@e@e@e@e@e@e@e@e@e@e@e@e@e@e@e@e@e@e@e@e@e@e@e@e@e@e@e@@e@e@e@e@e@e@e@e@e@e@e@e@e@e@e@e@e@..",
        "......................................................................................................"
    ]
}