{
    "name": "kiva_xxlarge_cma-mae_global_opt_unrepaired",
    "weight": false,
    "n_row": 101,
    "n_col": 102,
    "n_endpoint": 40,
    "n_agent_loc": 40,
    "maxtime": 5000,
    "layout": [
        "..@@@@@@@@@@@......e@@@@...................................................................@@@@@@@....",
        "w.............ee@@@@@...e@@@@@@@@@@@@@@@@@@@@@@@@@@@@@@@@@@@@@@@@@@@@@@@@@@@@@@@@@@e@@@@@@@........e.w",
        "..@@@@@@@@@@@@@@@.....@@@@.........................................................ee.......e@@@@@@@..",
        "..................e@@@.....@@@@@eeeeeeeee...eeeeeeeeeeeeeeeeee@@@@@@@@@@@@@@@@@@@@....ee@@@@@.........",
        "w.@@@@@@@@@@@@@@@@@...e@@@@.....e@@@@@@@@@@@@@@@@@@@@@@@@@@@@@e.....................@@@@.....e@@@@@@.w",
        "....................e@@.....e@@e................................eee@@@@@@@@@@@@@@@@@......@@@@........",
        "..@@@@@@@@@@@@@@@@@@@@@@@@@@@..e@@@@@@@@@@@@@@@@@@@@@@@@@@@@@@@@@@@..................e@@@@@...@@@@@@..",
        "w.............................e....................................@@@@@@@@@@@@@@@@@@@.....@@@@......w",
        "..@@@@@@@@@@@@@@@@@@@@@@@@@@@@@@@@@@@@@@@@@@@@@@@@@@@@@@@@@@@@@@eee....................e@@@....ee@@@..",
        ".............e.................................................ee@@@@@@@@@@@@@@@@@@@@@@e...e@@@@@.....",
        "w.@@@@@@@@@@@...@@@@@@@@@@@@@@@@@@@@@@@@@@@@@@@@@@@@@@@@@@@@@ee.............e...........e@@@......ee.w",
        "..............e@.............................................@@@@@@@@@@@@@@...e..e@@@@@@@...@@@@@@@e..",
        "..@@@@@@@@@@@@@@@@@@@@@ee@@@@@@@@@@@@@@@@@@@@@@@@@@@@@@@@@.e...............@@@@@@@........ee..........",
        "w.....................e@@................................e@@@@@@@@@@@@@@@@.........@@@@@@@@@@@@@@@@@.w",
        "..@@@@@@@@@@@@@@@@@@@@....@@@@@@@@@@@@@@@@@@@@@@@@@@@@@.e.................@@@@@@@.....................",
        ".......................@@@e...........................e@@@@@@@@@@@@@@@@@@........@@@@@@ee@@@@@@@@@@@..",
        "w.@@@@@@@@@@@@e@@@@@@@@...e@@@@@@@@@@@@@@@@@@@@@@@@@ee...................e@@@@@@@.....e@@@...........w",
        ".............ee........@@@@.........................@@@@@@@@@@@@@@@@@@@@@.........eee......e@@@@@@@@..",
        "..@@@@@@@@@@@...e@@@@@@@...@@@@@@@@@@@@@@@@@@@@@@@@......................e@@@@@@@@@@@@@@@@@@..........",
        "w.............@@@@......e@@..........................@@@@@@@@@@@@@@@@@@@@@...................eeeeeee.w",
        "..@@@@@@@@@@@@.....eee@@@..@@@@@@@@@@@@@@@@@@@@@@@@@@.....................e@@@@@@@@@@@@@@@@@@@@@e@@...",
        "..............e@@@@@@@....e...........................e@@@@@@@@@@@@@@@@@@@@@.......................e..",
        "w.@@@@@@@@...@...e@@...@@@@@@@@@@@@@@@@@@@@@@@@@@@@@@@@......................eeee@@@@@@@@@@@@@@@@@@@.w",
        ".............@..e.....e.................................e@@@@@@@@@@@@@@@@@@@@@@@@e....................",
        "..@@@@@@@@.@.@.@....e@e@@@@@@@@@@@@@@@@@@@@@@@@@@@@@@@@@@..........................eee@@@@@@@@@@@@@@..",
        "w..........@.@.@.@.@e@@...................................e@@@@@@@@@@@@@@@@@@@@@@@@@@@e..............w",
        "..@@@@@@@@.@.@.@.@.@.....eee@@@@@@@@@@@@@@@@@@@@@@@@@@@@@@@..............................e@@@@ee@@@@..",
        "...........@.@.@.@.@e@@@@@@@e...............................ee@@@@@@@@@@@@@@@@@@@@@@@@@@@@....e@......",
        "w.@e@@@@.@.@.@.@.@.@e..........e@@@@@@@@@@@@@@@@@@@@@@@@@@@@@..............................e@....eee.w",
        ".........@.@.@.@.@.@e@@@@@@@@@@@@................e............@@@@@@@@@@@@@@@@@@@@@@@@@@@@@@.e@@@@@e..",
        "..@@@.e@.@.@.@.@.@.@e.............e@@@@@@@@@@@@@...eee@@@@@@@@........................................",
        "w......@.@.@.@.@.@.@e@@@@@@@@@@@@@@.............@@@@@@.........e@@@@@@@@@@@@@@@@@@@@@@@@@@@@@@@@@@@@.w",
        "..@.@@.@.@.@.@.@.@.@e...............e@@@@@@@@@@@.......ee@@@@@@@......................................",
        "..@....@.@.@.@.@.@.@e@@@@@@@@@@@@@@@@...........e@@@@@@@@........e@@@@@@@@@@@@@@@@@@@@@@@@@@@@@@@@@@..",
        "w.@e@@.@.@.@.@.@.@.@....ee............e@@@@@@@@@@.........@@@@@@@@...................................w",
        ".......@.@.@.@.@.@.........eee@@@@@@@@@@..........@@@@@@@@.........e@@@@@@@@@@@@@@@@@@@@@@@@@@@@@@@e..",
        "..@..@.@.@.@.@.@.@e@@@@@@@@@@@e..........e@@@@@@@@........@@@@@@@@@@..................................",
        "w.@..@.@.@.@.@.@.@..............eee@@@@@@@.........e@@@@@@..........e@@@@@@@@@@@@@@@@@@@@@@@@@@@@@e..w",
        "..@..@.@.@.@.@.@.@e.ee@eeeeeee@@@@@e.......ee@@@@@@@......@@@@@@@@@@@.............................e...",
        "..@..@.@.@.@.@.@.@e@@@@@@@@@@@e.......ee@@@@@.......@@@@@@...........@@@@@@@@@@@@@@@@@@@@@@@@@@@@.....",
        "w.@..@.@.@.@.@.@.@..............eee@@@@.......e@@@@@@......@@@@@@@@@@..............ee.............e..w",
        "..@..@.@.@.@.@.@..e@@@@@@@@@@@@@@@@@....@@@@@@@......e@@@@...........e@@@@@eeeeeee....eeeee@@@@@@@....",
        "..@..@.@.@.@.@.@.@@...eee..ee.......ee@@@.......e@@@@e....e@@@@@@@@@@.....e@@@@@@@@@@@@@@@@@.....@e...",
        "w.@..@.@.@.@.@.@....e..........ee@@@@@e..@@@@@@@@.....e@@@@...........@@@@........................e..w",
        "..@..@.@.@.@.@.@.@e@@@@@@@@@@@@@@.......e.........e@@@@....@@@@@@@@@@@.....@@@@@@@@@@@@@@@@@@@@@@@e...",
        "..@..@.@.@.@.@.@.@................@@@@@@@@@@@@@@@@@....@@@@@..........@@@@@......................@e...",
        "w.@..@.@.@.@.@.@.@..eeeeee@@@@@@@@.................e@@@.....e@@@@@@@@......e@@@@@@@@@@@@@@@@@@@..@e..w",
        "..@..@.@.@.@.@.@.@.@@@@@@@@.......e@@@@@@@@@@@@@@@@@...e@@@@.........e@@@@@@.....................@e...",
        "..@..@.@.@.@.@.@.@...........eeee...................@@@@....e@@@@@@@@........e@@@@@@@@@@@@@@@@@..@e...",
        "w.@..@.@.@.@.@.@.@e@@@@@@@@@@@@@@@@@@@@@@@@@@@@@@@@@....@@@@.........e@@@@@@@@...................@e..w",
        "..@..@.@.@.@.@.@.@..................................@@@@....e@@@@@@@@@.........e@@@@@@@@@@@@@@@e.@e...",
        "..@..@.@.@.@.@.@.@...@@@@@@@@@@@@eee@@@@@@@@@@@@@@@e....e@@@...........eee@@@@@@...........ee.....e...",
        "w.@.@@.@.@.@.@.@.@e@@...........e@@@e..............e@@@@....e@@@@@@@@@@@@@e......@@@@@@@@@........e..w",
        "..@....@.@.@.@.@.@....e@@@eeeee.......eeee@@@@@@@@......@@@@.................ee@e........e@@@@@@@@e...",
        "..@e@@@@.@.@.@.@.@.@e@@...e@@@@@@@@@@@@@@@e.......e@@@@@.....@@@@@@@@@@@@@@@@@@@@@@@@@@@@.........e...",
        "w.@e.....@.@.@.@.@.@....e....................eeeee......@@@@............................e@@@@@@@@@e..w",
        "..@e@@@@.@.@.@.@.@.@.@@@@@@@@@@@@@@@@@@@@@@@@@@@@@@@@@@@....e@@@@@@@@@@@@@@@@@@@@@@eee@@@........@e...",
        "..@e.....@.@.@.@.@.@.@..e.ee............................e@@@@.....................e@@@@@e@@@@@@...e...",
        "w.@e@@@@@@.@.@.@.@.@.........ee@@@@@@@e...ee@@@@@@@@@@@@@.....ee@@@@@@@@@@@eeeeee.............e@@@@..w",
        "...e.......@.@.@.@.@...@@@@@@@@.......e@@@@@@.......e...e@@@@@@@@....ee..ee@@@@@@@@@@@@@@@@@@.........",
        "..@@@@@@@@.@.@.@.@.@............eee@@.........eeeee....e..........ee..........................@@@@@@..",
        "w..........@.@.@.@.@e@@@@@@@@@@@@@@@@e@@@@@@@@@@@@@@@@@@@@@@@@@@@@@@@@@@@@@@@@@@@@@@@@@@@@@@@@.......w",
        "..@@@@@@@@@@.@.................................................................................ee@@@..",
        "...........@.@@@@@@@@@@@@@@@@@@@@@@@@@@@@@@@@@@@@@@@@@@@@@@@@@@@@@@@@@@@@@@@@@@@@@@@@@@@@@@@@@@@@.....",
        "w.@@...e@@@.......................................................................................ee.w",
        "..@.@@@...e@@@@@@@@@@@@@@@@@@@@@@@@@@@@@@@@@@@@@@@@@@@@@@@@@@@@@@@@@@@@@@@@@@@@@@@@@@@@@@@@@@@@@@@@e..",
        "..@e..................................................................................................",
        "w.....e@@@@@@@@@@@@@@@@@@@@@@@@@@@@@@@@@@@@@@@@@@@@@@@@@@@@@@@@@@@@@@@@@@@@@@@@@@@@@@@@@@@@@@@@@@@@@.w",
        "..@@..................................................................................................",
        "..@@@@@@@@@@@@@@@@@@@@@@@@@@@@@@@@@@@@@@@@@@@@@@@@@@@@@@@@@@@@@@@@@@@@@@@@@@@@@@@@@@@@@@@@@@@@@@@@@@..",
        "w....................................................................................................w",
        "..@@@@@@@@@@@@@@@@@@@@@@@@@@@@@@@@@@@@@@@@@@@@@@@@@@@@@@@@@@@@@@@@@@@@@@@@@@@@@@@@@@@@@@@@@@@@@@@@@@..",
        "......................................................................................................",
        "w.@@@@@@@@@@@@@@@@@@@@@@@@@@@@@@@@@@@@@@@@@@@@@@@@@@@@@@@@@@@@@@@@@@@@@@@@@@@@@@@@@@@@@@@@@@@@@@@@@@.w",
        "......................................................................................................",
        "..@@@@@@@@@@@@@@@@@@@@@@@@@@@@@@@@@@@@@@@@@@@@@@@@@@@@@@@@@@@@@@@@@@@@@@@@@@@@@@@@@@@@@@@@@@@@@@@@@@..",
        "w....................................................................................................w",
        "..@@@@@@@@@@@@@@@@@@@@@@@@@@@@@@@@@@@@@@@@@@@@@@@@@@@@@@@@@@@@@@@@@@@@@@@@@@@@@@@@@@@@@@@@@@@@@@@@@@..",
        "......................................................................................................",
        "w.@@@@@@@@@@@@@@@@@@@@@@@@@@@@@@@@@@@@@@@@@@@@@@@@@@@@@@@@@@@@@@@@@@@@@@@@@@@@@@@@@@@@@@@@@@@@@@@@@@.w",
        "......................................................................................................",
        "..@@@@@@@@@@@@@@@@@@@@@@@@@@@@@@@@@@@@@@@@@@@@@@@@@@@@@@@@@@@@@@@@@@@@@@@@@@@@@@@@@@@@@@@@@@@@@@@@@@..",
        "w....................................................................................................w",
        "..@@@@@@@@@@@@@@@@@@@@@@@@@@@@@@@@@@@@@@@@@@@@@@@@@@@@@@@@@@@@@@@@@@@@@@@@@@@@@@@@@@@@@@@@@@@@@@@@@@..",
        "......................................................................................................",
        "w.@@@@@@@@@@@@@@@@@@@@@@@@@@@@@@@@@@@@@@@@@@@@@@@@@@@@@@@@@@@@@@@@@@@@@@@@@@@@@@@@@@@@@@@@@@@@@@@@@@.w",
        "......................................................................................................",
        "..@@@@@@@@@@@@@@@@@@@@@@@@@@@@@@@@@@@@@@@@@@@@@@@@@@@@@@@@@@@@@@@@@@@@@@@@@@@@@@@@@@@@@@@@@@@@@@@@@@..",
        "w....................................................................................................w",
        "..@@@@@@@@@@@@@@@@@@@@@@@@@@@@@@@@@@@@@@@@@@@@@@@@@@@@@@@@@@@@@@@@@@@@@@@@@@@@@@@@@@@@@@@@@@@@@@@@@@..",
        "......................................................................................................",
        "w.@@@@@@@@@@@@@@@@@@@@@@@@@@@@@@@@@@@@@@@@@@@@@@@@@@@@@@@@@@@@@@@@@@@@@@@@@@@@@@@@@@@@@@@@@@@@@@@@@@.w",
        "......................................................................................................",
        "..@@@@@@@@@@@@@@@@@@@@@@@@@@@@@@@@@@@@@@@@@@@@@@@@@@@@@@@@@@@@@@@@@@@@@@@@@@@@@@@@@@@@@@@@@@@@@@@@@@..",
        "w....................................................................................................w",
        "..@@@@@@@@@@@@@@@@@@@@@@@@@@@@@@@@@@@@@@@@@@@@@@@@@@@@@@@@@@@@@@@@@@@@@@@@@@@@@@@@@@@@@@@@@@@@@@@@@@..",
        "......................................................................................................",
        "w.@@@@@@@@@@@@@@@@@@@@@@@@@@@@@@@@@@@@@@@@@@@@@@@@@@@@@@@@@@@@@@@@@@@@@@@@@@@@@@@@@@@@@@@@@@@@@@@@@@.w",
        "......................................................................................................",
        "..@@@@@@@@@@@@@@@@@@@@@@@@@@@@@@@@@@@@@@@@@@@@@@@@@@@@@@@@@@@@@@@@@@@@@@@@@@@@@@@@@@@@@@@@@@@@@@@@@@..",
        "......................................................................................................"
    ]
}