{
    "name": "manufacture_101x102_tile_baseline_repaired",
    "layout": [
        ".....................................................................................................1",
        ".ee2eee0ee0ee2e1ee2ee0ee0ee2ee1ee1ee.ee2eee0ee0ee2e1ee2ee0ee0ee2ee1ee1ee.ee2eee0ee0ee2e1ee2ee0ee0ee2ee",
        ".1.e.1.e.e1e.e.e.e2e.e.e...........1.1.e.1.e.e1e.e.e.e2e.e.e...........1.1.e.1.e.e1e.e.e.e2e.e.e......",
        ".e.e.e.e.e.e.e.e.e.e.e.1.e.........e.e.e.e.e.e.e.e.e.e.e.e.1.e.........e.e.e.e.e.e.e.e.e.e.e.e.1.e....",
        ".e.1.1.1.1.0.2.1.0.1.2.ee1...........e.1.1.1.1.0.2.1.0.1.2.ee1...........e.1.1.1.1.0.2.1.0.1.2.ee1....",
        ".1.e.e.e.e.e.e.e.e.e.e.e.e...........1.e.e.e.e.e.e.e.e.e.e.e.e...........1.e.e.e.e.e.e.e.e.e.e.e.e....",
        ".e.e.e.e.e.e.e.e.e.e.e.2ee...........e.e.e.e.e.e.e.e.e.e.e.2ee...........e.e.e.e.e.e.e.e.e.e.e.2ee....",
        ".e.1.1.2.1.2.2.1.1.0.2.e.1...........e.1.1.2.1.2.2.1.1.0.2.e.1...........e.1.1.2.1.2.2.1.1.0.2.e.1....",
        ".1.e.e.e.e.e.e.e.e.e.e.e.e...........1.e.e.e.e.e.e.e.e.e.e.e.e...........1.e.e.e.e.e.e.e.e.e.e.e.e....",
        ".e.e.e.e.e.e.e.e.e.e.e.1.e...........e.e.e.e.e.e.e.e.e.e.e.1.e...........e.e.e.e.e.e.e.e.e.e.e.1.e....",
        ".e.1.1.1.2.2.2.1.2.1.2.0.1...........e.1.1.1.2.2.2.1.2.1.2.0.1...........e.1.1.1.2.2.2.1.2.1.2.0.1....",
        ".2.e.e.e.e.e.e.e.e.e.e.e.e...........2.e.e.e.e.e.e.e.e.e.e.e.e...........2.e.e.e.e.e.e.e.e.e.e.e.e....",
        ".e.e.e.e.e.e.e.e.e.e.e.e.e...........e.e.e.e.e.e.e.e.e.e.e.e.e...........e.e.e.e.e.e.e.e.e.e.e.e.e....",
        ".e.2.1.2.1.1.1.2.1.0.1.1.1...........e.2.1.2.1.1.1.2.1.0.1.1.1...........e.2.1.2.1.1.1.2.1.0.1.1.1....",
        ".2.e.e.e.e.e.e.e.e.e.e.e.e...........2.e.e.e.e.e.e.e.e.e.e.e.e...........2.e.e.e.e.e.e.e.e.e.e.e.e....",
        ".e.e.e.e.e.e.e.e.e.e.e.e.e...........e.e.e.e.e.e.e.e.e.e.e.e.e...........e.e.e.e.e.e.e.e.e.e.e.e.e....",
        ".e.2.1.1.1.0.0.1.1.0.1.1.1...........e.2.1.1.1.0.0.1.1.0.1.1.1...........e.2.1.1.1.0.0.1.1.0.1.1.1....",
        ".0.e.e.e.e.e.e.e.e.e.e.e.e...........0.e.e.e.e.e.e.e.e.e.e.e.e...........0.e.e.e.e.e.e.e.e.e.e.e.e....",
        ".e.e.e.e.e.e.e.e.e.e.e.e.e...........e.e.e.e.e.e.e.e.e.e.e.e.e...........e.e.e.e.e.e.e.e.e.e.e.e.e....",
        ".e.1.2.1.2.2.1.1.2.1.1.0.1...........e.1.2.1.2.2.1.1.2.1.1.0.1...........e.1.2.1.2.2.1.1.2.1.1.0.1....",
        ".1.e.e.e.e.e.e.e.e.e.e.e.e...........1.e.e.e.e.e.e.e.e.e.e.e.e...........1.e.e.e.e.e.e.e.e.e.e.e.e....",
        ".e.e.e.e.e.e.e.e.e.e.e.e.e...........e.e.e.e.e.e.e.e.e.e.e.e.e...........e.e.e.e.e.e.e.e.e.e.e.e.e....",
        ".e.1.2.1.1.0.2.0.1.0.1.1.2...........e.1.2.1.1.0.2.0.1.0.1.1.2...........e.1.2.1.1.0.2.0.1.0.1.1.2....",
        ".1.e.e.e.e.e.e.e.e.e.e.e.e...........1.e.e.e.e.e.e.e.e.e.e.e.e...........1.e.e.e.e.e.e.e.e.e.e.e.e....",
        ".e.e.e.e.e.e.e.e.e.e.e.e.e...........e.e.e.e.e.e.e.e.e.e.e.e.e...........e.e.e.e.e.e.e.e.e.e.e.e.e....",
        ".e.1.1.1.1.0.1.1.2.2.1.0.0...........e.1.1.1.1.0.1.1.2.2.1.0.0...........e.1.1.1.1.0.1.1.2.2.1.0.0....",
        ".1.e.e.e.e.e.e.e.e.e.e.e.e...........1.e.e.e.e.e.e.e.e.e.e.e.e...........1.e.e.e.e.e.e.e.e.e.e.e.e....",
        ".e.e.e.e.e.e.e.e.e.e.e.e.e...........e.e.e.e.e.e.e.e.e.e.e.e.e...........e.e.e.e.e.e.e.e.e.e.e.e.e....",
        ".e.0.1.2.1.1.2.1.2.2.0.1.1...........e.0.1.2.1.1.2.1.2.2.0.1.1...........e.0.1.2.1.1.2.1.2.2.0.1.1....",
        ".1.e.e.e.e.e.e.e.e.e.e.e.e...........1.e.e.e.e.e.e.e.e.e.e.e.e...........1.e.e.e.e.e.e.e.e.e.e.e.e....",
        ".e.e.e.e.e.e.e.e.e.e.e.e.e...........e.e.e.e.e.e.e.e.e.e.e.e.e...........e.e.e.e.e.e.e.e.e.e.e.e.e....",
        ".e.2.1.1.2.2.1.2.2.1.1.1.2...........e.2.1.1.2.2.1.2.2.1.1.1.2...........e.2.1.1.2.2.1.2.2.1.1.1.2....",
        "e1.e.e.e.e.e.e.e.e.e.e.e.e..........e1.e.e.e.e.e.e.e.e.e.e.e.e..........e1.e.e.e.e.e.e.e.e.e.e.e.e....",
        ".....................................................................................................0",
        ".ee2eee0ee0ee2e1ee2ee0ee0ee2ee1ee1ee.ee2eee0ee0ee2e1ee2ee0ee0ee2ee1ee1ee.ee2eee0ee0ee2e1ee2ee0ee0ee2ee",
        ".1.e.1.e.e1e.e.e.e2e.e.e...........1.1.e.1.e.e1e.e.e.e2e.e.e...........1.1.e.1.e.e1e.e.e.e2e.e.e......",
        ".e.e.e.e.e.e.e.e.e.e.e.1.e.........e.e.e.e.e.e.e.e.e.e.e.e.1.e.........e.e.e.e.e.e.e.e.e.e.e.e.1.e....",
        ".e.1.1.1.1.0.2.1.0.1.2.ee1...........e.1.1.1.1.0.2.1.0.1.2.ee1...........e.1.1.1.1.0.2.1.0.1.2.ee1....",
        ".1.e.e.e.e.e.e.e.e.e.e.e.e...........1.e.e.e.e.e.e.e.e.e.e.e.e...........1.e.e.e.e.e.e.e.e.e.e.e.e....",
        ".e.e.e.e.e.e.e.e.e.e.e.2ee...........e.e.e.e.e.e.e.e.e.e.e.2ee...........e.e.e.e.e.e.e.e.e.e.e.2ee....",
        ".e.1.1.2.1.2.2.1.1.0.2.e.1...........e.1.1.2.1.2.2.1.1.0.2.e.1...........e.1.1.2.1.2.2.1.1.0.2.e.1....",
        ".1.e.e.e.e.e.e.e.e.e.e.e.e...........1.e.e.e.e.e.e.e.e.e.e.e.e...........1.e.e.e.e.e.e.e.e.e.e.e.e....",
        ".e.e.e.e.e.e.e.e.e.e.e.1.e...........e.e.e.e.e.e.e.e.e.e.e.1.e...........e.e.e.e.e.e.e.e.e.e.e.1.e....",
        ".e.1.1.1.2.2.2.1.2.1.2.0.1...........e.1.1.1.2.2.2.1.2.1.2.0.1...........e.1.1.1.2.2.2.1.2.1.2.0.1....",
        ".2.e.e.e.e.e.e.e.e.e.e.e.e...........2.e.e.e.e.e.e.e.e.e.e.e.e...........2.e.e.e.e.e.e.e.e.e.e.e.e....",
        ".e.e.e.e.e.e.e.e.e.e.e.e.e...........e.e.e.e.e.e.e.e.e.e.e.e.e...........e.e.e.e.e.e.e.e.e.e.e.e.e....",
        ".e.2.1.2.1.1.1.2.1.0.1.1.1...........e.2.1.2.1.1.1.2.1.0.1.1.1...........e.2.1.2.1.1.1.2.1.0.1.1.1....",
        ".2.e.e.e.e.e.e.e.e.e.e.e.e...........2.e.e.e.e.e.e.e.e.e.e.e.e...........2.e.e.e.e.e.e.e.e.e.e.e.e....",
        ".e.e.e.e.e.e.e.e.e.e.e.e.e...........e.e.e.e.e.e.e.e.e.e.e.e.e...........e.e.e.e.e.e.e.e.e.e.e.e.e....",
        ".e.2.1.1.1.0.0.1.1.0.1.1.1...........e.2.1.1.1.0.0.1.1.0.1.1.1...........e.2.1.1.1.0.0.1.1.0.1.1.1....",
        ".0.e.e.e.e.e.e.e.e.e.e.e.e...........0.e.e.e.e.e.e.e.e.e.e.e.e...........0.e.e.e.e.e.e.e.e.e.e.e.e....",
        ".e.e.e.e.e.e.e.e.e.e.e.e.e...........e.e.e.e.e.e.e.e.e.e.e.e.e...........e.e.e.e.e.e.e.e.e.e.e.e.e....",
        ".e.1.2.1.2.2.1.1.2.1.1.0.1...........e.1.2.1.2.2.1.1.2.1.1.0.1...........e.1.2.1.2.2.1.1.2.1.1.0.1....",
        ".1.e.e.e.e.e.e.e.e.e.e.e.e...........1.e.e.e.e.e.e.e.e.e.e.e.e...........1.e.e.e.e.e.e.e.e.e.e.e.e....",
        ".e.e.e.e.e.e.e.e.e.e.e.e.e...........e.e.e.e.e.e.e.e.e.e.e.e.e...........e.e.e.e.e.e.e.e.e.e.e.e.e....",
        ".e.1.2.1.1.0.2.0.1.0.1.1.2...........e.1.2.1.1.0.2.0.1.0.1.1.2...........e.1.2.1.1.0.2.0.1.0.1.1.2....",
        ".1.e.e.e.e.e.e.e.e.e.e.e.e...........1.e.e.e.e.e.e.e.e.e.e.e.e...........1.e.e.e.e.e.e.e.e.e.e.e.e....",
        ".e.e.e.e.e.e.e.e.e.e.e.e.e...........e.e.e.e.e.e.e.e.e.e.e.e.e...........e.e.e.e.e.e.e.e.e.e.e.e.e....",
        ".e.1.1.1.1.0.1.1.2.2.1.0.0...........e.1.1.1.1.0.1.1.2.2.1.0.0...........e.1.1.1.1.0.1.1.2.2.1.0.0....",
        ".1.e.e.e.e.e.e.e.e.e.e.e.e...........1.e.e.e.e.e.e.e.e.e.e.e.e...........1.e.e.e.e.e.e.e.e.e.e.e.e....",
        ".e.e.e.e.e.e.e.e.e.e.e.e.e...........e.e.e.e.e.e.e.e.e.e.e.e.e...........e.e.e.e.e.e.e.e.e.e.e.e.e....",
        ".e.0.1.2.1.1.2.1.2.2.0.1.1...........e.0.1.2.1.1.2.1.2.2.0.1.1...........e.0.1.2.1.1.2.1.2.2.0.1.1....",
        ".1.e.e.e.e.e.e.e.e.e.e.e.e...........1.e.e.e.e.e.e.e.e.e.e.e.e...........1.e.e.e.e.e.e.e.e.e.e.e.e....",
        ".e.e.e.e.e.e.e.e.e.e.e.e.e...........e.e.e.e.e.e.e.e.e.e.e.e.e...........e.e.e.e.e.e.e.e.e.e.e.e.e....",
        ".e.2.1.1.2.2.1.2.2.1.1.1.2...........e.2.1.1.2.2.1.2.2.1.1.1.2...........e.2.1.1.2.2.1.2.2.1.1.1.2....",
        "e1.e.e.e.e.e.e.e.e.e.e.e.e..........e1.e.e.e.e.e.e.e.e.e.e.e.e..........e1.e.e.e.e.e.e.e.e.e.e.e.e....",
        "......................................................................................................",
        ".ee2eee0ee0ee2e1ee2ee0ee0ee2ee1ee1ee.ee2eee0ee0ee2e1ee2ee0ee0ee2ee1ee1ee.ee2eee0ee0ee2e1ee2ee0ee0ee21e",
        ".1.e.1.e.e1e.e.e.e2e.e.e...........1.1.e.1.e.e1e.e.e.e2e.e.e...........1.1.e.1.e.e1e.e.e.e2e.e.e......",
        ".e.e.e.e.e.e.e.e.e.e.e.1.e.........e.e.e.e.e.e.e.e.e.e.e.e.1.e.........e.e.e.e.e.e.e.e.e.e.e.e.1.e....",
        ".e.1.1.1.1.0.2.1.0.1.2.ee1...........e.1.1.1.1.0.2.1.0.1.2.ee1...........e.1.1.1.1.0.2.1.0.1.2.ee1....",
        ".1.e.e.e.e.e.e.e.e.e.e.e.e...........1.e.e.e.e.e.e.e.e.e.e.e.e...........1.e.e.e.e.e.e.e.e.e.e.e.e....",
        ".e.e.e.e.e.e.e.e.e.e.e.2ee...........e.e.e.e.e.e.e.e.e.e.e.2ee...........e.e.e.e.e.e.e.e.e.e.e.2ee....",
        ".e.1.1.2.1.2.2.1.1.0.2.e.1...........e.1.1.2.1.2.2.1.1.0.2.e.1...........e.1.1.2.1.2.2.1.1.0.2.e.1....",
        ".1.e.e.e.e.e.e.e.e.e.e.e.e...........1.e.e.e.e.e.e.e.e.e.e.e.e...........1.e.e.e.e.e.e.e.e.e.e.e.e....",
        ".e.e.e.e.e.e.e.e.e.e.e.1.e...........e.e.e.e.e.e.e.e.e.e.e.1.e...........e.e.e.e.e.e.e.e.e.e.e.1.e....",
        ".e.1.1.1.2.2.2.1.2.1.2.0.1...........e.1.1.1.2.2.2.1.2.1.2.0.1...........e.1.1.1.2.2.2.1.2.1.2.0.1....",
        ".2.e.e.e.e.e.e.e.e.e.e.e.e...........2.e.e.e.e.e.e.e.e.e.e.e.e...........2.e.e.e.e.e.e.e.e.e.e.e.e....",
        ".e.e.e.e.e.e.e.e.e.e.e.e.e...........e.e.e.e.e.e.e.e.e.e.e.e.e...........e.e.e.e.e.e.e.e.e.e.e.e.e....",
        ".e.2.1.2.1.1.1.2.1.0.1.1.1...........e.2.1.2.1.1.1.2.1.0.1.1.1...........e.2.1.2.1.1.1.2.1.0.1.1.1....",
        ".2.e.e.e.e.e.e.e.e.e.e.e.e...........2.e.e.e.e.e.e.e.e.e.e.e.e...........2.e.e.e.e.e.e.e.e.e.e.e.e....",
        ".e.e.e.e.e.e.e.e.e.e.e.e.e...........e.e.e.e.e.e.e.e.e.e.e.e.e...........e.e.e.e.e.e.e.e.e.e.e.e.e....",
        ".e.2.1.1.1.0.0.1.1.0.1.1.1...........e.2.1.1.1.0.0.1.1.0.1.1.1...........e.2.1.1.1.0.0.1.1.0.1.1.1....",
        ".0.e.e.e.e.e.e.e.e.e.e.e.e...........0.e.e.e.e.e.e.e.e.e.e.e.e...........0.e.e.e.e.e.e.e.e.e.e.e.e....",
        ".e.e.e.e.e.e.e.e.e.e.e.e.e...........e.e.e.e.e.e.e.e.e.e.e.e.e...........e.e.e.e.e.e.e.e.e.e.e.e.e....",
        ".e.1.2.1.2.2.1.1.2.1.1.0.1...........e.1.2.1.2.2.1.1.2.1.1.0.1...........e.1.2.1.2.2.1.1.2.1.1.0.1....",
        ".1.e.e.e.e.e.e.e.e.e.e.e.e...........1.e.e.e.e.e.e.e.e.e.e.e.e...........1.e.e.e.e.e.e.e.e.e.e.e.e....",
        ".e.e.e.e.e.e.e.e.e.e.e.e.e...........e.e.e.e.e.e.e.e.e.e.e.e.e...........e.e.e.e.e.e.e.e.e.e.e.e.e....",
        ".e.1.2.1.1.0.2.0.1.0.1.1.2...........e.1.2.1.1.0.2.0.1.0.1.1.2...........e.1.2.1.1.0.2.0.1.0.1.1.2....",
        ".1.e.e.e.e.e.e.e.e.e.e.e.e...........1.e.e.e.e.e.e.e.e.e.e.e.e...........1.e.e.e.e.e.e.e.e.e.e.e.e....",
        ".e.e.e.e.e.e.e.e.e.e.e.e.e...........e.e.e.e.e.e.e.e.e.e.e.e.e...........e.e.e.e.e.e.e.e.e.e.e.e.e....",
        ".e.1.1.1.1.0.1.1.2.2.1.0.0...........e.1.1.1.1.0.1.1.2.2.1.0.0...........e.1.1.1.1.0.1.1.2.2.1.0.0....",
        ".1.e.e.e.e.e.e.e.e.e.e.e.e...........1.e.e.e.e.e.e.e.e.e.e.e.e...........1.e.e.e.e.e.e.e.e.e.e.e.e....",
        ".e.e.e.e.e.e.e.e.e.e.e.e.e...........e.e.e.e.e.e.e.e.e.e.e.e.e...........e.e.e.e.e.e.e.e.e.e.e.e.e....",
        ".e.0.1.2.1.1.2.1.2.2.0.1.1...........e.0.1.2.1.1.2.1.2.2.0.1.1...........e.0.1.2.1.1.2.1.2.2.0.1.1....",
        ".1.e.e.e.e.e.e.e.e.e.e.e.e...........1.e.e.e.e.e.e.e.e.e.e.e.e...........1.e.e.e.e.e.e.e.e.e.e.e.e....",
        ".e.e.e.e.e.e.e.e.e.e.e.e.e...........e.e.e.e.e.e.e.e.e.e.e.e.e...........e.e.e.e.e.e.e.e.e.e.e.e.e....",
        ".e.2.1.1.2.2.1.2.2.1.1.1.2...........e.2.1.1.2.2.1.2.2.1.1.1.2...........e.2.1.1.2.2.1.2.2.1.1.1.2....",
        "e1.e.e.e.e.e.e.e.e.e.e.e.e..........e1.e.e.e.e.e.e.e.e.e.e.e.e..........e1.e.e.e.e.e.e.e.e.e.e.e.e....",
        ".....2...................................2...................................2......................e2",
        "1ee2eee0ee0ee2e1ee2ee0ee0ee2ee1ee1ee1ee2eee0ee0ee2e1ee2ee0ee0ee2ee1ee1ee1ee2eee0ee0ee2e1ee2ee0ee0ee2ee"
    ],
    "nca_runtime": null,
    "milp_runtime": 86.84415984153748,
    "nca_milp_runtime": null,
    "sim_score": null,
    "weight": false,
    "n_row": 101,
    "n_col": 102,
    "n_0": 211,
    "n_1": 750,
    "n_2": 394,
    "n_stations": 1355
}