{
    "name": "manufacture_large_93_stations",
    "weight": false,
    "n_row": 33,
    "n_col": 36,
    "n_0": 11,
    "n_1": 27,
    "n_2": 55,
    "n_stations": 93,
    "layout": [
        "....................................",
        "..ee....ee....ee....ee....ee....e...",
        ".e00e..e00e..e00e..e00e..e00e..e0e..",
        "..ee....ee....ee....ee....ee....e...",
        "....................................",
        "..ee......ee.....ee.....ee......ee..",
        ".e11e....e11e...e11e...e11e....e11e.",
        "..ee......ee.....ee.....ee......ee..",
        "....................................",
        "..ee......ee.....ee.....ee......ee..",
        ".e11e....e11e...e11e...e11e....e11e.",
        "..ee......ee.....ee.....ee......ee..",
        "....................................",
        "..ee....ee....ee....ee....ee....ee..",
        ".e11e..e12e..e22e..e22e..e11e..e11e.",
        "..ee....ee....ee....ee....ee....ee..",
        "....................................",
        "..ee....ee....ee....ee....ee....ee..",
        ".e22e..e22e..e22e..e22e..e22e..e22e.",
        "..ee....ee....ee....ee....ee....ee..",
        "....................................",
        "..ee....ee....ee....ee....ee....ee..",
        ".e22e..e22e..e22e..e22e..e22e..e22e.",
        "..ee....ee....ee....ee....ee....ee..",
        "....................................",
        "..ee....ee....ee....ee....ee....ee..",
        ".e22e..e22e..e22e..e22e..e22e..e22e.",
        "..ee....ee....ee....ee....ee....ee..",
        "....................................",
        "..ee...ee...ee...ee...ee...ee...ee..",
        ".e22e.e22e.e22e.e22e.e22e.e22e.e22e.",
        "..ee...ee...ee...ee...ee...ee...ee..",
        "...................................."
    ]
}