{
    "name": "kiva_101x102_tile_baseline_uneven_repaired",
    "layout": [
        "...e.............................@.e.............................@.e@............................@.e..",
        "w..@.@.@.@.@.@.@.@.@.@.@.@.@..e@@e.@.@.@.@.@.@.@.@.@.@.@.@.@..e@@e.@.@.@.@.@.@.@.@.@.@.@.@.@..e@@e.@.w",
        "...e.e.e.e.e.e.e.e.e.e@e.e.e@.@e@@.e.e.e.e.e.e.e.e.e.e.e.e.e@.@e@@.e.e@e.e.e.e.e.e.e@e.e.e.e@.@e@@.e..",
        "...@.e@e.e.@.e.e.e.@......ee.......@.e@e.e.@.e.e.e.@.....@ee.......@.e@@.e.@.e.e.e.@.@....ee.......@..",
        "w..e.e@e.@.@.@.@.@.e.@e@e@@@@e@@e@.e.e@e.@.e.@.@.@.e.@e@e@@@@e@@e@.@.@@e.@.e.@.@.@.@.@e@e@@@@e@@e@@e.w",
        "...e.e.e.e.e.e.e.e.e...............e.e.e.e.e.@.e.@.e.....@.........e.e.e.e.e.e.e.e.e...............e..",
        "...@.@.@.@.@.e.e.e.@.@e@@e@@e@@e@@.@.@.@.@.@.e.e.e.@.@e@@e@@e@@e@@.@.@.@.@.@.e@e.e.@.@e@@e@@e@@e@@.@..",
        "w..e.e.e@e.e.@.@.@.e.e...........e.e.e.e.e.e.@.@.@.e.e...........e.e.e.e.e.e.@.@.@.e.e.........@.e.@.w",
        "...e.e.e.e.e.e.e.e.e.e@@e@@e@@e@@@.e.e.e.e.e.e.e.e.e.e@@e@@e@@e@@@.e.e.@.e.e.e.e.@.@.e@@e@@e@@e@@@.e..",
        "...@.@.@.@.@.e.e.e.@.e..........e..@.@.@.@.@.@.e.e.@.e..........e..@.@.@.@.@.e.e.e.@.e..........e..@..",
        "w..e.e.e.e.e.@.@.@.e.@.@e@@e@@e@@@.e.e.e.e.e.@.@.@.e.@.@e@@e@@e@@@@e.e.e.e.e.@.@.@.e.@.@e@@e@@e@@@.@.w",
        "...e.e.e.e.e.e.e.e.e.e...........e.@.e.e.e.e.e.e.e.e.e...........e.e.e.e.e.e.e.e.e@e.e...........e.e..",
        "...@.@.@.@.@.e.e.e.@.e.@e@@.@.@.@@.@.@.@.@.@.e.e.e.@.e.@e@@.@.@.@@.@.@.@.@.@.e.e.e.@.e.@e@@.@.@.@@.@..",
        "w..e.e.e.e.e.@.@.@.e.@....e.e.e.e..e.e.e.e.e.@.@.@.e.@....e.e.e@e..e.e@e.e.e.@.@.@.e.@....e.e.e.e..e.w",
        "...@.e.e@e.e.e.e.e.e.e.@@.@.@.@.@..@.e.e.e.e.e.e.e.e.e.@@.@.@.@.@..@.e@e.e.e.@.e.e.e.e.@@.@.@.@.@..@..",
        "...e.@.@.@.@.e.e.e.@.e.ee.e.e.e.e..e.@.@.@.@.e.e.e.@.e.ee.@.@.e.e.@e.@.@.@.@.e.e.e.@.@.ee.e.e.e.e..@..",
        "w..e.e.e.e.e.@.@.@.e.@.ee@e.e.@.e..e.e.e.e.e.@.@.@.e.@.ee@e.e.@.e..e.e.e.e.e.@.@.@.e.@.ee@e.e.@.@..e.w",
        "...@.e.e.e.e.e.e.e.e.e.@..e.@.e.@..@.e.e@e.e.e.e@e.e.e.@..e.@.e.@..@.e.e.e.e.e.e.e.@.e.@..e.@.@.@..@..",
        "...e.@.@.@.@.e.e.e.@.e.e..@.e.e.e..e.@.@.@.@.e@e.e.@.e.e..@.e.e.e..e.@.@.@.@.e.e.e.@.e.e..@.@.e.e..@..",
        "w..e.e.e.e.e.@.@.@.e.@.@e.e.e.@.e..e.e.e.e.e.@.@.@.e@@.@e.e.e.@.e..e.e.e.e.e.@.@.@.e.@.@e.e.e.@.e..e.w",
        "...@.e.e.e.e.e.@.e.e.e....e.@.e.@..@.e.e.e.e.e.e.e.e.e....e.@.e.@..@.e.e.@.e.e.e.e.e.e....e.@.e.@..@..",
        "...e.@.@.@.@.e.e@e.@.@@@e@@.e.e.e..e.@.@.@.@.e@@@e.@.@@@e@@.e.e.@..e.@.@.@.@.@.e@e@@.@@@e@@.e.e.e..@..",
        "w..e.e.e.e.e.@.e......e.....e.@.e..e.e.e.e@e.@.e......e.....e.@.e@.e.e.e.e.e.@.e.@....e.....e.@.e..e.w",
        "...@.e.e.e.e.e.@.e@@e@@@e@@.@.e.@..@.e.e.e.e.e.@.e@@e@@@e@@.@.e.@..@.e.e.e.@.e.@.e@@e@@@e@@.@.e.@..@..",
        "..@e.@.@.@.@.e.e.e........e...e....e.@.@.@.@.e.e.e........e...e...@e.@.@.@.@.e.@.e...@....e...e....e..",
        "w..e.e.e.e.e.@.e@@e@@e@@e@@@e@@@@..e.e.e.e.e.@.e@@e@@e@@e@@@e@@@@..e.e.@.e.e.@.e@@e@@e@@e@@@e@@@@..@.w",
        "...@.e.e.......................eee.@.e.e.......................eee.@.e.e.@.....................eee.@..",
        "...e.@.@.e@@e@@e@@e@@@e@@e@@@e@@@@.e.@.@.e@@e@@e@@e@@@e@@e@@@e@@@@.e.@.@.e@@e@@e@@e@@@e@@e@@@e@@@@.e..",
        "w..e.e.e.e@.........e......e.......e.e.e.e@.........e......e.......e.e.e.e@.........e.....@e.......@.w",
        "...@.e.e...@e@@e@@e@@@e@@e@@@e@@@@.@.e.e...@e@@e@@e@@@e@@e@@@e@@@@.@.e.e...@e@@e@@e@@@e@@e@@@e@@@@.@..",
        "...e.@.@.e...............@.....eee.e.@.@.e.....................eee.e.@.@.e...................@.eee.e..",
        "w.@e.e.e.@@e@@e@@e@@e@@e@@e@@e@@@@@e.e.e.@@e@@e@@e@@e@@e@@e@@e@@@@@e.e.e.@@e@@e@@e@@e@@e@@e@@e@@@@@e.w",
        "...........@..........................................................................................",
        "...e.............................@.e.............................@.e.............................@.e..",
        "w..@.@.@.@.@.@.@.@.@.@.@.@.@..e@@e.@.@.@.@.@.@.@.@.@.@.@.@.@..e@@e.@.@.@.@.@.@.@.@.@.@.@.@.@..e@@e.@.w",
        "...e.e.e.e.e.e.e.e.e.e.e.e.e@.@e@@.e@e.e.e.e.e.e.e.e.e.e.e.e@.@e@@.e.e@e.e.e.e.e.e.e.e.e@e.e@.@e@@@e..",
        "...@.e@e.e.@.e.e.e.@...@..ee.......@.e@e@e.@.e.e.e.@......ee.......@.e@e.@.@.e.e.e.@......ee.@.....@..",
        "w..e.e@e.@.e.@.@.@@e.@e@e@@@@e@@e@.e@e@e.@.e.@.@.@.e.@e@e@@@@e@@e@.e.e@e.@@e.@.@.@.e.@e@e@@@@e@@e@.@.w",
        "...e.e.e.e.e.e.e.e.e...............e.e.e.e.e.e.e.e.@...............e.e.e.e.e.@.e.e.e...............e..",
        "...@.@.@.@.@.e.e.e.@.@e@@e@@e@@e@@.@.@.@.@.@.e.e.e.@.@e@@e@@e@@e@@.@.@.@.@.@@e.e.e.@.@e@@e@@e@@e@@.@..",
        "w.@e.e.e.e.e.@.@.@.e.@...........e@e.e.e.@.e.@.@.@.e.e...........e.e.e.e@e.e.@.@.@.e.e...........e.e.w",
        "...e.e.e.e.e.e.e.e.e.e@@e@@e@@e@@@.@.e.@.e.e.e.e.e.e.e@@e@@e@@e@@@.e@e.@.e.e@e.e.e.e.e@@e@@e@@e@@@.@..",
        "...@.@.@.@.@.e.e.e.@.e..........e..@.@.@.@.@.e.e.e.@.e..........e..@.@.@.@.@.e.e.e.@.e..........e..@..",
        "w..e.e.e.e.e.@.@.@.e.@.@e@@e@@e@@@.e@e.e.e.e.@.@.@.e.@.@e@@e@@e@@@.@.e.e@e.@.@.@.@.e.@.@e@@e@@e@@@@e.w",
        "..@e.e.e.e.e.e.e.e.e.e...........e.e@e.e.e.e.e.e.e.e.e...........e.e.e.e.@.e@e@e.e@e.e...........e.@..",
        "...@.@.@.@.@.e.e.e.@.e@@e@@.@.@.@@.@.@.@.@.@.e.e.e.@.e.@e@@.@.@.@@.@.@.@.@.@.e.e@e.@.e.@e@@.@.@.@@.@..",
        "w..e.e.e.e.e.@.@.@.e.@....e.e.e@e..e.e@@@e.e.@.@.@.e.@....e.e.e.e..e.e.e.e.e.@.@.@.@.@..@.e.e.e.e..e.w",
        "...@.e.e.e.e.e.e.e.e.e.@@.@.@.@.@..@.e.e@e.e@e.@.e.e.e.@@.@.@.@.@..@.e@e.e.e@e.@.e.e.e.@@.@.@.@.@..@..",
        "..@e.@.@.@.@.@.e.e.@.e.ee.e.e.e.e..e@@.@.@.@.e.e.e.@.e.ee.e.e.e@e..e.@.@.@.@.e.e.e.@.e.ee.e@e.e.e..@..",
        "w..e.e.e.e.e.@.@.@.e.@.ee@e.e.@.e..e.e.e.e.e.@.@.@.e.@.e@@e.e.@.e..@.e.e@e.e.@.@.@.e.@.ee@e.@.@@e..e.w",
        "...@.e.e.e@e.e.e.e.e.e.@..e.@.e.@..@.@.@.@.e.e.e.e.e.e.@.@e.@.e.@..@.@.e.e.e.e@e.e.e.e.@..e.@.e.@..@..",
        "...e.@.@.@.@.e.e.e.@.e.e..@.e.e.e..e.@.@.@.@.e.e.e.@.e.e..@.e.@.@..e.@.@.@.@@e.e.e.@.e@e..@.e@@.e..@..",
        "w..e.e.e.e.e.@.@.@.e.@.@e.e.e.@.e..e.e@e.e.e.@.@.@.e.@.@e.e.e.@.e..e.e.e.e.e@@.@.@.e@@.@e.@.e.@.e..e.w",
        "...@.e.e.e.e.e.e.e.e.e....e.@.e.@..@.@.e.e.e.e@e.e.e.e....e.@.e.@..@.@.e.e.e.e@e@e.e.e..@.e.@.e@@..@..",
        "...e.@.@.@.@.e.@@e.@.@@@e@@.e.e.e..e.@.@.@.@.e.e@e.@.@@@e@@.e.e.e..e.@.@.@.@.e.e@e.@.@@@e@@.e.e.e..e..",
        "w..e.e.e.e.e.@.e......e@....e.@.e..e.e.e.e.e.@.e......e.....e.@.e..e.e.e.e.e.@.e......e.....e.@.e..@.w",
        "...@.e.e.e.e.e.@.e@@e@@@e@@.@.e.@..@.e.e.e.e.e.@.e@@e@@@e@@.@.e.@..@.e.e.e.e.e.@.e@@e@@@e@@.@.e.@..@..",
        "...e.@.@.@.@.e.e.e........e...e....e.@.@.@.@.e.e.e......@.e...e....e.@.@.@.@.e.e.e........e@..e....e..",
        "w..e.e.e.e.e.@.e@@e@@e@@e@@@e@@@@..e.e.e.e.e.@.e@@e@@e@@e@@@e@@@@..e.e.e.e.e.@.e@@e@@e@@e@@@e@@@@..@.w",
        "...@.@.e................@......eee.@.e.e.......................eee.@.e.e....................@..eee.@..",
        "...e.@.@.e@@e@@e@@e@@@e@@e@@@e@@@@.e.@.@.e@@e@@e@@e@@@e@@e@@@e@@@@.e.@.@.e@@e@@e@@e@@@e@@e@@@e@@@@.e..",
        "w..e.e.e.e@.........e......e.......e.e.e.e@.........e......e@......e.e.e.e@.........e......e@......e.w",
        "...@.e.e...@e@@e@@e@@@e@@e@@@e@@@@.@.e.e...@e@@e@@e@@@e@@e@@@e@@@@.@.e.e...@e@@e@@e@@@e@@e@@@e@@@@.@..",
        "...e.@.@.e.....................eee.e.@.@.e..........@..........eee.e.@.@.e.....................eee.@..",
        "w.@e.e.e.@@e@@e@@e@@e@@e@@e@@e@@@@@e.e.e.@@e@@e@@e@@e@@e@@e@@e@@@@@e.e.e.@@e@@e@@e@@e@@e@@e@@e@@@@@e.w",
        ".................................................@.................................................@..",
        "...e..........................@..@.e.............................@@e.............................@.e..",
        "w..@.@.@.@.@.@.@.@.@.@.@.@.@..e@@e.@.@.@.@.@.@.@.@.@.@.@.@.@..e@@e.@.@.@.@.@.@.@.@.@.@.@.@.@..e@@e.@.w",
        "...e.e.e.e.e.e.e.e.e.e.e.e.e@.@e@@.e.e.e.e.e.e.e.e.e.e.e.e.e@.@e@@.e.e.e.e.e.e.e.e.e.e.e.e.e@.@e@@.e..",
        "...@.e@e.e.@.e.e.e.@......ee.......@.e@e.e.@.e.e.e.@......ee.@.....@.e@e.e.@.e.e.e.@......ee.......@..",
        "w..e.e@e.@.e.@.@.@.e.@e@e@@@@e@@e@.e.e@e.@.e.@.@.@.e.@e@e@@@@e@@e@.e.e@e.@.e.@.@.@.e.@e@e@@@@e@@e@.@.w",
        "...e.e.e.e.e.e.e.e.e...............e.e.e.e.e.e.e.e.e...............e.e.@.e.e@e.e.e.e.....@......@..e..",
        "...@.@.@.@.@.e.e.e.@.@e@@e@@e@@e@@.@.@.@.@.@.e.e.e.@.@e@@e@@e@@e@@.@.@.@.@.@.e@e.e.@.@e@@e@@e@@e@@.@..",
        "w..e.e@e.e.e.@.@.@.e.e...........e.e.e.e.e.e.@.@.@.e.e...........e.e.e.e.e.@.@.@.@.e.e...........e.@.w",
        "...e.e.e@e.e.e@e.e.e.e@@e@@e@@e@@@.e.e.e.e.e.e.e.e.e.e@@e@@e@@e@@@.e.e.e.e.e.e.e.e.e.e@@e@@e@@e@@@@e..",
        "...@.@.@.@.@.e.e.e.@.e..........e..@.@.@.@.@.e.e.e.@.e..........e..@.@.@.@.@.@.@.@.@.e.....@....e..@..",
        "w..e.e.e.@.e.@.@.@.e.@.@e@@e@@e@@@.e.e.e.e.e.@.@.@.e.@.@e@@e@@e@@@.e.e.e.e.e@@.@.@.e.@.@e@@e@@e@@@.@.w",
        "...e.e.e.e.e.e.e.e.e.e...........e.e.e.e.e.e.e.e.e.@.e...........e.e.e.e.e.e.e.e.e.e.e..@........e.e..",
        "...@.@.@.@.@.e.e.e.@.e.@e@@.@.@.@@.@.@.@.@.@.e.e.e.@.e.@e@@.@.@.@@.@.@.@.@.@.e.e.e@@.@.@e@@.@.@.@@.@..",
        "w..e.e.e.e.e.@.@.@.e.@....e.e.e.e..e.e.e.e.e.@.@.@.e.@....e.e.e.e..e.e.e.e@e.@.@.@.e.@....e.e.e.e..e.w",
        "...@.e.e.e.e.e.e.e.e.e.@@.@.@.@.@..@.e.e.e.e.@.e.e.e.e.@@.@.@.@.@..@.@.e.e.e.e.e.e.e.e.@@.@.@.@.@..@..",
        "...e.@.@.@.@.e.e.e.@.e.ee.e.e.e.e..e.@.@.@.@.e.e.e.@.e.ee.e.e.e.e..e.@.@.@.@.e.e.e.@.e.ee.e@e.e.e.@e..",
        "w..e.e.e.e.e.@.@.@.e@@.ee@e.e.@.e..e.e.e.e.e.@.@.@.e.@.ee@e.e.@.e..e.e.e.e.e.@.@.@.e.@.@e@e.e.@.e.@e.w",
        "...@.e.e.e.e.e.e.e.e.e.@..e.@.e.@..@.e@e.e.e.e.e.e.e@e.@..e.@.e.@..@.e.e.@.e.e.e.e.e.e.@..e.@.e.@..@..",
        "..@e@@.@.@.@.e.e.e.@.e.e..@.e.e.e..e.@.@.@.@.e.e.e.@.e.e..@.e.e.e..e@@.@.@.@.e.e@e.@.e.e..@.e.e.e@.@..",
        "w.@e.e.e.e.e.@.@.@.e.@.@e.e.e.@.e..e.e.e.e.e.@.@.@.e.@.@e.e.e.@.@..e.@@e.e.e.@.@.@.e.@.@e.@.e.@.e..e.w",
        "...@.e.e.e.e.@.e.e.e.e....e.@.e.@..@.e.e.e.e.e.e.e.e.e....e.@.e.@..@.e.e.e.e.e.e.@.e.e....e.@.e.@..@..",
        "...e@@.@.@.@.e.e@e.@.@@@e@@.e.@.e..e.@.@.@.@.e.e@e.@.@@@e@@.e.e.e..e.@.@.@.@.e.e@e.@.@@@e@@.e.e.e..@..",
        "w..e.e.e.e.e.@.e......e.....e.@.e..e.e.e.e.e.@.e......e.....e@@.e@.e.e.e.e.e.@.e......e.....e.@.e..e.w",
        "...@.e.e.e.e.@.@.e@@e@@@e@@.@.e.@..@.e.e.e.e.e.@.e@@e@@@e@@.@.e.@..@.e.e.e.e.e@@.e@@e@@@e@@.@.e.@..@..",
        "...e.@.@.@.@.e.e.e........e..@e....e.@.@.@.@.e.e@e........e@..e....e.@.@.@.@.e.e.@........e...e....e..",
        "w.@e@e.e.e.e.@.e@@e@@e@@e@@@e@@@@..@.@.e.e.e.@.e@@e@@e@@e@@@e@@@@..e.e.e.e.e.@.e@@e@@e@@e@@@e@@@@..@.w",
        "...@.e.e................@......eee.@.e.e.......................eee.@.e.e....................@..eee.@..",
        "..@e.@.@.e@@e@@e@@e@@@e@@e@@@e@@@@.e.@.@.e@@e@@e@@e@@@e@@e@@@e@@@@.e.@.@.e@@e@@e@@e@@@e@@e@@@e@@@@.e..",
        "w..e.e.e@e@.........e......e.......e.e.e.e@.........e......e.......e.e.e@e@.........e......e......@e.w",
        "...@.e.e...@e@@e@@e@@@e@@e@@@e@@@@.@.e.e...@e@@e@@e@@@e@@e@@@e@@@@.@.e@e...@e@@e@@e@@@e@@e@@@e@@@@.@..",
        "...e.@.@.e.....................eee.e.@.@.e.......@@......@.....eee.e.@.@.e.....................eee.@..",
        "w.@e.e.e.@@e@@e@@e@@e@@e@@e@@e@@@@@e.e.e.@@e@@e@@e@@e@@e@@e@@e@@@@@e.e.e.@@e@@e@@e@@e@@e@@e@@e@@@@@e.w",
        "....................@..............................................................................@..",
        "...e.............................@.e.............................@.e.............................@.e..",
        "...@.@e@.@e@.@e@.@e@.@e@.@e@.@e@@e.@.@e@.@e@.@e@.@e@.@e@.@e@.@e@@e.@.@e@.@e@.@e@.@e@.@e@.@e@.@e@@e.@.."
    ],
    "nca_runtime": null,
    "milp_runtime": 61.32874917984009,
    "nca_milp_runtime": null,
    "sim_score": null,
    "weight": false,
    "n_row": 101,
    "n_col": 102,
    "n_endpoint": 2391,
    "n_agent_loc": 0,
    "n_shelf": 2500,
    "maxtime": 5000
}