{
    "name": "kiva_101x102_tile_baseline_repaired",
    "layout": [
        "....@...@@...@......@...@...@@..@....@..........@.....................................................",
        "w.e@ee@@ee@@ee@@ee@@ee@@ee@@ee@.e@e@ee@@ee@@ee@@ee@@ee@@ee@@ee@.e@e@ee@@ee@@ee@@ee@@ee@@ee@@ee@.e@e@.w",
        "..@..................................................................................@................",
        "...@ee@@ee@@ee@@ee@@ee@@ee@@ee@@e..@ee@@ee@@ee@@ee@@ee@@ee@@ee@@e..@ee@@ee@@ee@@ee@@ee@@ee@@ee@@e..@..",
        "w...........................................................................................@......e.w",
        "...@ee@@ee@@ee@@ee@@ee@@ee@@ee@.e@.@ee@@ee@@ee@@ee@@ee@@ee@@ee@.e@.@ee@@ee@@ee@@ee@@ee@@ee@@ee@.e@.@..",
        "......................................................................................................",
        "w.e@ee@@ee@@ee@@ee@@ee@@ee@@ee@@e@e@ee@@ee@@ee@@ee@@ee@@ee@@ee@@e@e@ee@@ee@@ee@@ee@@ee@@ee@@ee@@e@e@.w",
        "......................................................................................................",
        "..e@@e@@ee@@ee@@ee@@ee@@ee@@ee@@e.e@ee@@ee@@ee@@ee@@ee@@ee@@ee@@e.e@@e@@ee@@ee@@ee@@ee@@ee@@ee@@e.e@..",
        "w.@..................................................................................................w",
        "..e@@e@@ee@@ee@@ee@@ee@@ee@@ee@@e@e@ee@@ee@@ee@@ee@@ee@@ee@@ee@ee@e@@e@@ee@@ee@@ee@@ee@@ee@@ee@ee@e@..",
        "..@................................................................................................e..",
        "w..@ee@@ee@@ee@@ee@@ee@@ee@@ee@ee@.@ee@@ee@@ee@@ee@@ee@@ee@@e@@ee@.@ee@@ee@@ee@@ee@@ee@@ee@@ee@ee@.@.w",
        "...................................................................................................@..",
        "..@ee@@e.e@@ee@@ee@@ee@@ee@@ee@@e.@ee@@e.e@@ee@@ee@@ee@@ee@@ee@@e.@ee@@e.e@@ee@@ee@@ee@@ee@@ee@@e.@e..",
        "w....................................................................................................w",
        "..@ee@@ee@.@ee@@ee@@ee@@ee@@ee@@e.@ee@@ee@.@ee@@ee@@ee@@ee@@ee@@e.@ee@@ee@.@ee@@ee@@ee@@ee@@ee@@e.@e..",
        "...................................................................................................@..",
        "w.@ee@@ee@@e.e@@ee@@ee@@ee@@ee@@e.@ee@@ee@@e.e@@ee@@ee@@ee@@ee@@e.@ee@@ee@@e.e@@ee@@ee@@ee@@ee@@e.@e.w",
        "......................................................................................................",
        "..@ee@@ee@@e.e@@ee@@ee@@ee@@ee@@e.@ee@@ee@@e.e@@ee@@ee@@ee@@ee@@e.@ee@@ee@@e.e@@ee@@ee@@ee@@ee@@e.@e..",
        "w..................................................................................................@.w",
        "..@ee@@ee@@e.e@@ee@@ee@@ee@@ee@@e@@ee@@ee@@e.e@@ee@@ee@@ee@@ee@ee@@ee@@ee@@e.e@@ee@@ee@@ee@@ee@ee@@e..",
        "......................................................................................................",
        "w.@ee@@ee@@e@@e@@e@@ee@@ee@@ee@.e@@ee@@ee@@ee@e@@e@@ee@@ee@@ee@.e@@ee@@ee@@e@@e@ee@@ee@@ee@@ee@.e@@e.w",
        "...................................................................................................@..",
        "..@ee@@ee@@ee@@e.e@@ee@@ee@@ee@ee@@ee@@ee@@ee@@e.e@@ee@@ee@@ee@@e@@ee@@ee@@ee@@e.e@@ee@@ee@@ee@@e@@e..",
        "w....................................................................................................w",
        "..@ee@@ee@@ee@e@ee@@ee@@ee@@ee@.e@@ee@@ee@@ee@e@@e@@ee@@ee@@ee@.e@@ee@@ee@@ee@e@ee@@ee@@ee@@ee@.e@@e..",
        "......................................................................................................",
        "w...e@@ee@@ee@.@ee@@ee@@ee@@ee@@e...e@@ee@@ee@.@ee@@ee@@ee@@ee@@e...e@@ee@@ee@.@ee@@ee@@ee@@ee@@e....w",
        "......................................................................................................",
        "..@...................................................................................................",
        "w.e@ee@@ee@@ee@@ee@@ee@@ee@@ee@.e@e@ee@@ee@@ee@@ee@@ee@@ee@@ee@.e@e@@e@@ee@@ee@@ee@@ee@@ee@@ee@.e@e@.w",
        "..@...................................................................................................",
        "...@ee@@ee@@ee@@ee@@ee@@ee@@ee@@e..@ee@@ee@@ee@@ee@@ee@@ee@@ee@@e..@ee@@ee@@ee@@ee@@ee@@ee@@ee@@e..@..",
        "w..................................................................................................e.w",
        "...@ee@@ee@@ee@@ee@@ee@@ee@@ee@.e@.@ee@@ee@@ee@@ee@@ee@@ee@@ee@.e@.@ee@@ee@@ee@@ee@@ee@@ee@@ee@.e@.@..",
        "..@...................................................................................................",
        "w.e@@e@@ee@@ee@@ee@@ee@@ee@@ee@@e@e@@e@@ee@@ee@@ee@@ee@@ee@@ee@@e@e@@e@@ee@@ee@@ee@@ee@@ee@@ee@@e@e@.w",
        "......................................................................................................",
        "..e@ee@@ee@@ee@@ee@@ee@@ee@@ee@@e.e@@e@@ee@@ee@@ee@@ee@@ee@@ee@@e.e@ee@@ee@@ee@@ee@@ee@@ee@@ee@@e.e@..",
        "w.@..................................................................................................w",
        "..e@ee@@ee@@ee@@ee@@ee@@ee@@ee@e@@e@@e@@ee@@ee@@ee@@ee@@ee@@ee@ee@e@ee@@ee@@ee@@ee@@ee@@ee@@ee@@e@e@..",
        "..@...................................................................................................",
        "w..@ee@@ee@@ee@@ee@@ee@@ee@@ee@@e@.@ee@@ee@@ee@@ee@@ee@@ee@@ee@ee@.@ee@@ee@@ee@@ee@@ee@@ee@@ee@ee@.@.w",
        "...................................................................................................e..",
        "..@ee@@e.e@@ee@@ee@@ee@@ee@@ee@@e.@ee@@e.e@@ee@@ee@@ee@@ee@@ee@@e.@ee@@e.e@@ee@@ee@@ee@@ee@@ee@@e.@e..",
        "w.......................................................................................@............w",
        "..@ee@@ee@.@ee@@ee@@ee@@ee@@ee@@e.@ee@@ee@.@ee@@ee@@ee@@ee@@ee@@e.@ee@@ee@.@ee@@ee@@ee@@ee@@ee@@e.@e..",
        "......................................................................................................",
        "w.@ee@@ee@@e.e@@ee@@ee@@ee@@ee@@e.@ee@@ee@@e.e@@ee@@ee@@ee@@ee@@e.@ee@@ee@@e.e@@ee@@ee@@ee@@ee@@e.@e.w",
        "......................................................................................................",
        "..@ee@@ee@@e.e@@ee@@ee@@ee@@ee@@e.@ee@@ee@@e.e@@ee@@ee@@ee@@ee@@e.@ee@@ee@@e.e@@ee@@ee@@ee@@ee@@e.@e..",
        "w....................................................................................................w",
        "..@ee@@ee@@e.e@@ee@@ee@@ee@@e@@ee@@ee@@ee@@e.e@@ee@@ee@@ee@@e@@ee@@ee@@ee@@e.e@@ee@@ee@@ee@@ee@ee@@e..",
        "......................................................................................................",
        "w.@ee@@ee@@ee@e@@e@@ee@@ee@@ee@.e@@ee@@ee@@e@@e@ee@@ee@@ee@@ee@.e@@ee@@ee@@e@@e@ee@@ee@@ee@@ee@.e@@e.w",
        "......................................................................................................",
        "..@ee@@ee@@ee@@e.e@@ee@@ee@@ee@@e@@ee@@ee@@ee@@e.e@@ee@@ee@@ee@ee@@ee@@ee@@ee@@e.e@@ee@@ee@@ee@ee@@e..",
        "w..........@........................................@.......@........................................w",
        "..@ee@@ee@@ee@e@ee@@ee@@ee@@ee@.e@@ee@@ee@@ee@e@ee@@ee@@ee@@ee@.e@@ee@@ee@@ee@e@@e@@ee@@ee@@ee@.e@@e..",
        "...................................@.......@..@.....@...............@.................................",
        "w...e@@ee@@ee@.@ee@@ee@@ee@@ee@@e...e@@ee@@ee@.@ee@@ee@@ee@@ee@@e...e@@ee@@ee@.@ee@@ee@@ee@@ee@@e....w",
        "........................................@...@...@@......@....@........................................",
        "..................................@.........@@.......@...@............................................",
        "w.e@ee@@ee@@ee@@ee@@ee@@ee@@ee@.e@e@ee@@ee@@ee@@ee@@ee@@ee@@ee@@e@e@ee@@ee@@ee@@ee@@ee@@ee@@ee@.e@e@.w",
        "....................................@............@......@@......@.....................................",
        "...@ee@@ee@@ee@@ee@@ee@@ee@@ee@@e..@ee@@ee@@ee@@ee@@ee@@ee@@ee@@e@.@ee@@ee@@ee@@ee@@ee@@ee@@ee@@e..@..",
        "w...........................@.......................@@...@...@.....................................e.w",
        "...@ee@@ee@@ee@@ee@@ee@@ee@@ee@.e@.@ee@@ee@@ee@@ee@@ee@@ee@@ee@.e@.@ee@@ee@@ee@@ee@@ee@@ee@@ee@.e@.@..",
        ".........................................@......@....@......@@..@............@........................",
        "w.e@ee@@ee@@ee@@ee@@ee@@ee@@ee@@e@e@@e@@ee@@ee@@ee@@ee@@ee@@ee@@e@e@ee@@ee@@ee@@ee@@ee@@ee@@ee@@e@e@.w",
        "........................................@@......@.......@...@.....@.....@.............................",
        "..e@@e@@ee@@ee@@ee@@ee@@ee@@ee@@e.e@@e@@ee@@ee@@ee@@ee@@ee@@ee@@e.e@@e@@ee@@ee@@ee@@ee@@ee@@ee@@e.e@..",
        "w....................................@......@@...@..........@..@.........@...........................w",
        "..e@ee@@ee@@ee@@ee@@ee@@ee@@ee@@e@e@@e@@ee@@ee@@ee@@ee@@ee@@ee@e@@e@ee@@ee@@ee@@ee@@ee@@ee@@e@@e@@e@..",
        "....................................@...@....@...@...@......@...@..................................e..",
        "w..@ee@@ee@@ee@@ee@@ee@@ee@@ee@@e@.@ee@@ee@@ee@@ee@@ee@@ee@@e@@ee@.@ee@@ee@@ee@@ee@@ee@@ee@@ee@@e@.@.w",
        ".......................................@@@......@@......@@.....@.....@...@............................",
        "..@ee@@e.e@@ee@@ee@@ee@@ee@@ee@@e.@ee@@e.e@@ee@@ee@@ee@@ee@@ee@@e.@ee@@e@e@@ee@@ee@@ee@@ee@@ee@@e.@e..",
        "w...................@...................@@..@....@...@.......@.........@.............................w",
        "..@ee@@ee@.@ee@@ee@@ee@@ee@@ee@@e.@ee@@ee@.@ee@@ee@@ee@@ee@@ee@@e.@ee@@ee@.@ee@@ee@@ee@@ee@@ee@@e.@e..",
        ".......................................@@...@@......@...@...@...@..@...@@.............................",
        "w.@ee@@ee@@e.e@@ee@@ee@@ee@@ee@@e.@ee@@ee@@e@e@@ee@@ee@@ee@@ee@@e.@ee@@ee@@e.e@@ee@@ee@@ee@@ee@@e.@e.w",
        "................................@...@...@.......@...@...@...@...@..@@...@.............................",
        "..@ee@@ee@@e.e@@ee@@ee@@ee@@ee@@e.@ee@@ee@@e.e@@ee@@ee@@ee@@ee@@e.@ee@@ee@@e.e@@ee@@ee@@ee@@ee@@e.@e..",
        "w.......................@..........@.................@...@......@..@...@....................@........w",
        "..@ee@@ee@@e.e@@ee@@ee@@ee@@e@@ee@@ee@@ee@@e.e@@ee@@ee@@ee@@e@@ee@@ee@@ee@@e.e@@ee@@ee@@ee@@ee@@e@@e..",
        ".............................@..................@.......@...@@......@............@....................",
        "w.@ee@@ee@@ee@e@ee@@ee@@ee@@ee@.e@@ee@@ee@@e@@e@@e@@ee@@ee@@ee@@e@@ee@@ee@@e@@e@@e@@ee@@ee@@ee@.e@@e.w",
        "........................@..........@................@..............@@.......................@.........",
        "..@ee@@ee@@ee@@e.e@@ee@@ee@@ee@@e@@ee@@ee@@ee@@e.e@@ee@@ee@@ee@@e@@ee@@ee@@ee@@e@e@@ee@@ee@@ee@@e@@e..",
        "w...........@...................................@@...@...@...@.....@.......@.....@...@...............w",
        "..@ee@@ee@@e@@e@@e@@ee@@ee@@ee@.e@@ee@@ee@@ee@e@ee@@ee@@ee@@ee@@e@@ee@@ee@@ee@e@@e@@ee@@ee@@ee@.e@@e..",
        "............................................................@......@@.........@......@.............@..",
        "w...e@@ee@@ee@.@ee@@ee@@ee@@ee@@e...e@@ee@@ee@.@ee@@ee@@ee@@ee@@e@..e@@ee@@ee@.@ee@@ee@@ee@@ee@@e....w",
        "............@.......@.......................@....@..@.......@@......@......@@...@@...@..@...@@........",
        ".............................................................@..@....@...@...@..........@...@.........",
        "..e@@e@@ee@@ee@@ee@@ee@@ee@@ee@.e@e@@e@@ee@@ee@@ee@@ee@@ee@@ee@.e@e@ee@@ee@@ee@@ee@@ee@@ee@@ee@@e@e@.."
    ],
    "nca_runtime": null,
    "milp_runtime": 119.69674253463745,
    "nca_milp_runtime": null,
    "sim_score": null,
    "weight": false,
    "n_row": 101,
    "n_col": 102,
    "n_endpoint": 2275,
    "n_agent_loc": 0,
    "n_shelf": 2500,
    "maxtime": 5000
}