{
    "name": "manufacture_large_200_agents_dsage_opt_alpha=5",
    "weight": false,
    "n_row": 33,
    "n_col": 36,
    "layout": [
        "0e....e2......1......e............e2",
        "e.............e......2e.....0e.....2",
        "....2ee2......e......e.....e2e.....e",
        ".......e......1.........1e.....0....",
        "........................2e.....e..1e",
        "..........1e............e...........",
        "..................e...e1.....e2e....",
        ".......e2..e......2e...e........1e..",
        "..........11e2....e..1e.........e...",
        "..........e..e......................",
        "..e1..........1.............e2......",
        "..e2..........e..e....0......2e.....",
        "......e..........2....e......e0e....",
        "2e....2ee2e..........1e2......e.....",
        "e.....e.0........ee0.1e.............",
        ".................2........2e........",
        ".............0..e1e0..0......e2.....",
        ".............e...1....e...e1........",
        "........e....0...e.............e....",
        "........1......................0....",
        ".............1ee0e2............e....",
        ".e................e...e..e.......e.e",
        "e0............e1e.....2.e2e......1.2",
        ".e...................e...........1e.",
        "..................2e.0e.............",
        ".....................e..........e2..",
        "................................1...",
        "..............e.............e22e....",
        "...........e..2e0e...........ee.....",
        "..........e02e..e2.e2..e.......e1...",
        "...........1e..........0............",
        "..................e1e......ee...e...",
        "....e21e...................21...1ee1"
    ]
}