{
    "name": "manufacture_large_200_agents_cma-mae_idx_0=15_opt_alpha=5_sw=5",
    "layout": [
        "2e..e1e..e................e21e....e1",
        "e....e.ee2e................ee....e.e",
        "......e0ee......e...............e2e.",
        "......e1e......e1e..e............e..",
        "..e....e..e....e2e.e2e.e.e....e.....",
        ".e2e.e...e2e.e..e...e.e0e0e..e1e.eee",
        "2eeee2ee.e2ee0ee1e.e2e.e.e....eee222",
        "..e2eee0ee2e.e..e...e.........e1eeee",
        "...e...e..ee...e.....e.........e.e.e",
        "..........e0e.e2e...e2e.....e...e2e0",
        "...........eee1ee....e.....e0e.e2e.e",
        "...........e0eee0e..........e...e.e.",
        "......e....eee1eeee..............e0e",
        ".....e2e..e2e.e.e21e.........e...ee.",
        "..e..eee...e.....e2e...e....e0e.e21e",
        ".e1ee1e1e.........e...e0e...ee...ee.",
        "..e..e.e..........e...e2e..e0e...e0e",
        "........e..e.....e2e...e....ee.e..e.",
        "......ee0ee0ee....eee....e..e2e2e.e.",
        ".....e0ee..ee1e...e11e..e2e..e.e.e1e",
        "......e......e.....ee.ee.e....e...e.",
        "..e....e.............e22e...ee2e....",
        ".e0e..e0e....e..e..e..ee...e0ee.....",
        "..e..eee.e..e0ee0ee1e......ee.......",
        "....e01ee0e.e1e.e..e......e22e......",
        ".....ee..e...e.......ee.e..ee.......",
        "....................e02e1ee2e.......",
        "....................eee.ee.e..e.....",
        "........e..e.......e1e..e2e..e1e.e..",
        ".......e1ee0e.......e...e1e...e.e1e.",
        "........e..e.............e.......e..",
        "e...................................",
        "2..................................."
    ],
    "weight": false,
    "n_row": 33,
    "n_col": 36,
    "n_0": 27,
    "n_1": 28,
    "n_2": 40,
    "n_stations": 95
}