{
    "name": "manufacture_large_200_agents_cma-mae_sub_opt1_alpha=5",
    "weight": false,
    "n_row": 33,
    "n_col": 36,
    "layout": [
        "..e.................................",
        "1e2ee2ee0ee1ee1ee1ee0e1ee2ee1ee0ee2e",
        "....................................",
        "ee2ee1e0e2e0e2e0e0e0e2e0e2e0e2e0e0e.",
        "1...................................",
        "ee2e0e0ee0e0e2e0e2e0e2e0e2e0e2e.e2e0",
        "....................................",
        ".e2ee0ee2ee2e2e0e2e0e2e0e2e0e2e2e2e2",
        "....................................",
        "0e2e2e2e2e1eeee0e2e0e2e0e2e0e0e2e2..",
        "............11......................",
        "e0ee2e.e0e0eeee0e2e0e.e0e2ee0e.e1e..",
        "....................................",
        "e2e2e2e2ee2ee2e0e2e0e2e0e2e2e2e2e2..",
        "....................................",
        "e2ee1ee2ee0ee0e0e2e0e2ee2ee1e2e.e2e2",
        "....................................",
        "ee2ee2e2e2e2e2e2e2e0e2e2e2e.e1ee1ee0",
        "0...................................",
        "ee2e1ee0e.e1ee1e0ee0e0e0e2e2e2e2e2e0",
        "....................................",
        "e2e.e1ee0ee2e2e2e2e2ee0ee2ee0e2ee0e0",
        "....................................",
        "2e2e2e2e.e1ee0e.e2e2e2e2e2e2e2e2e2e.",
        "....................................",
        "1e2e2e2e2e2e.e0ee1ee1ee2ee0ee1e1ee0e",
        "....................................",
        "1ee1ee0ee2ee2e2e0ee2e2e2e2e2e2e2e2e0",
        "....................................",
        "1e2e2e2e2e2e2e2e2ee1e.e1ee2ee1ee0ee1",
        "....................................",
        "e1ee2ee1ee1ee1ee1e0ee2e2e2e.e2e2e2e0",
        "...................................."
    ]
}