{
    "name": "manufacture_large_200_agents_dsage_opt_alpha=5_sw=5",
    "layout": [
        "0e.........e1.........0e..........e2",
        "............e......e..e.............",
        "..................e0...0e...........",
        "......ee..e2e......e.e..............",
        "......20....e.......e1..............",
        "........ee.e2.e..e2..e.e1e..........",
        "........00....0.e0.e21.........1e02e",
        "........e..e2....e..ee........e2....",
        "............ee.e0.1...2.............",
        ".......e.e...1..e.e...e.............",
        ".2e....0e0..ee..1........2e0........",
        ".e.......e.e1...........ee.e......e0",
        ".......2....e..........e0...........",
        ".......e............e0..e.....2.1...",
        ".......0.........1...e........e.ee..",
        ".................e...............1..",
        "............e..........e...2e....e..",
        "............1.....e0e..22e..0e......",
        "e2..........e......e...ee...e.......",
        "........e...0.....1.....e2..........",
        "........1.........e...e1......2e....",
        "......e2..............e1.....1e.....",
        "...........2e...e2..................",
        "..........e2...e.e...e.......e2e....",
        ".....e.....e2..0....e0..............",
        ".....2e........e.............0e.1...",
        ".................e0.........ee..e...",
        "e.........1ee...e1.........e0.......",
        "1....e2e..e.0....e...........e......",
        "......e....e....2e.......e...1e....e",
        "........e..1e...e...e...e0...0e....0",
        "....e...1.......1e..0e.....e.e..2e.e",
        "....1e..........e..........02e....e1"
    ],
    "weight": false,
    "n_row": 33,
    "n_col": 36,
    "n_0": 32,
    "n_1": 28,
    "n_2": 31,
    "n_stations": 91
}