{
    "name": "manufacture_large_200_agents_cma-es_opt_alpha=5_sw=5",
    "layout": [
        "...e1ee1e.................e0e.....e1",
        "....e..e....e........e.....e.......e",
        ".........e.e2e......e2e...e.........",
        "........e2e1ee..e....e.e.e1e.....e1e",
        "......e..eeee1ee1e....e1e.e..e......",
        ".....e1e.e1e.e..e......e....e2e.....",
        "...e..e...e......e..e....e...e......",
        "..e2e...........e1ee2e..e1e.........",
        "...e.......e.....e..e0e..e.....ee...",
        "..e.......e0e...e....e.....e..e12e..",
        "..1e....e..e.e.e0e........e1e..ee...",
        "..e....e0e..e2eeee..e......e..e2e...",
        ".......ee.e..ee2e1ee0e.....e...e....",
        "....e.e2ee0e...e.e.ee0e...e2e.......",
        "...e0e.e..e....e..e1ee.....e........",
        "...ee.......e.e0e..e................",
        "...2e......e0e.e..........e.e..e....",
        "...e........e..e.e.......e2e0ee1e...",
        "..........e...e0e2e.......e.ee0e....",
        "....ee...e2e...eee............e.....",
        "...e12e...e....e1e....ee......e.....",
        "....ee...e......e....e02ee...e1e....",
        "........e1e...........eee0e.e.ee...e",
        "..e......e..........ee0e.e.e0ee2ee11",
        "..1................e1ee.....e..e....",
        "..e......e..........ee...........e1e",
        "........e0e.........e2e..e.......e1e",
        ".........e.........e.e..e1e......e1.",
        "..................e1e....e..........",
        "...............e...e................",
        "...............1....................",
        "e............e.e................e1ee",
        "1e...........1...................ee1"
    ],
    "nca_runtime": null,
    "milp_runtime": null,
    "nca_milp_runtime": null,
    "weight": false,
    "n_row": 33,
    "n_col": 36,
    "n_0": 19,
    "n_1": 37,
    "n_2": 20,
    "n_stations": 76
}