9,16
e0e........ee0ee
ee.....00.e0eee2
0e...e.ee..e...e
e.eee0e........e
0e00ee..ee....e0
e......e000eee1e
.e........e.0ee.
e0e........ee...
..........e0ee0e