{
    "name": "manufacture_milp_debug4",
    "weight": false,
    "n_row": 9,
    "n_col": 16,
    "layout": [
        "0000000000000000",
        "1111111111111111",
        "2222222222222222",
        "0000000000000000",
        "1111111111111111",
        "2222222222222222",
        "0000000000000000",
        "1111111111111111",
        "2222222222222222"
    ]
}