{
    "name": "manufacture_bad_env_benchmark1",
    "weight": false,
    "n_row": 33,
    "n_col": 36,
    "layout": [
        "....................................",
        "....................................",
        "....................................",
        "....................................",
        "....................................",
        "....................................",
        "....................................",
        "....................................",
        "....................................",
        "..........e.........................",
        ".........e0e........................",
        "..........e.........................",
        "....................................",
        "....................................",
        "....................................",
        ".....................e..............",
        "....................e1e.............",
        ".....................e..............",
        "....................................",
        "....................................",
        "....................................",
        "....................................",
        "....................................",
        "....................................",
        "....................................",
        "..........e.........................",
        ".........e2e........................",
        "..........e.........................",
        "....................................",
        "....................................",
        "....................................",
        "....................................",
        "...................................."
    ]
}