{
    "name": "manufacture_xxlarge_cma-mae_global_opt_repaired_one_endpt_throughput-hamming_a=5_iter=200",
    "layout": [
        "......................................................................................................",
        "...e.e0e.e0e.e0e.e.e0e0e.e0e.e0e.e0e.....e1e...............e.e.e.......e.e1e...e...e...e...e...e...e0e",
        "..e0e.e.e.e.e.e.e1e.e.e.e.e.e.e.e.e.e1e.e.e.e0e.e1e.e0e.e.e1e0e0e.e.e.e1e.e.e.e0e.e0e.e0e.e0e.e0e.e.e.",
        "...e.e.e0e.e0e.e.e.e0e.e1e.e0e.e0e.e.e.e0e.e.e.e.e.e.e.e0e.e.e.e.e2e1e.e.e.e1e.e.e.e.e.e.e.e.e.e.e0e..",
        "..e.e2e.e.e.e.e0e.e.e.e.e.e.e.e.e.e0e.e.e.e1e.e0e.e0e.e.e.e.e0e.e.e.e.e.e0e.e.e.e0e.e0e.e1e.e2e.e.e.e.",
        ".e1e.e.e.e1e.e.e.e0e.e1e.e1e.e1e.e.e.e2e.e1e.e.e.e.e.e0e.e1e.e.e1e.e.e1e.e.e.e0e.e.e.e.e.e.e.e.e2e.e0.",
        "..e.e.e0e.e.e0e.e.e.e.e.e.e.e.e.e1e.e.e.e.e.e0e.e1e.e.e.e.e.e0e.e.e1e.e.e.e0e.e.e.e0e.e0e.e0e.e.e.e.e.",
        "...e0e.e.e.e0e.e0e.e1e.e0e.e0e.e.e.e0e.e0e.e.e.e.e.e0e.e1e.e.e.e.e.e.e.e0e.e.e.e1e.e.e.e.e.e.e0e.e0e..",
        "e0e.e.e.e1e.e.e.e.e.e.e.e.e.e.e0e.e.e.e.e.e2e.e0e.e.e.e.e.e0e.e0e1e.e0e.e.e.e0e.e0e.e0e.e0e.e.e.e.e.e.",
        ".e.e.e0e.e.e.e0e.e0e.e1e.e0e.e.e.e0e.e2e.e.e.e.e.e0e.e1e.e.e.e.e.e.e.e.e.e0e.e.e.e.e.e.e.e.e0e.e2e.e0.",
        "..e2e.e.e.e0e.e.e.e.e.e.e.e.e0e.e.e.e.e.e1e.e0e.e.e.e.e.e0e.e1e.e.e1e.e0e.e.e.e0e.e1e.e0e.e.e.e.e.e.e.",
        ".e.e.e.e2e.e1e.e0e.e1e.e0e.e.e.e2e.e0e.e.e.e.e.e1e.e0e.e.e.e.e.e1e.e.e.e.e.e2e.e.e.e.e.e.e2e.e0e.e1e..",
        "e0e.e1e.e.e.e.e.e.e.e.e.e.e2e.e.e.e.e.e1e.e0e.e.e.e.e.e0e.e0e.e.e.e.e1e.e0e.e.e.e0e.e0e.e.e.e.e.e.e.e.",
        ".e.e.e.e.e1e.e0e.e0e.e0e.e.e.e0e.e0e.e.e.e.e.e0e.e1e.e.e.e.e.e1e.e0e.e.e.e.e.e1e.e.e.e.e0e.e0e.e0e.e0.",
        "..e0e.e0e.e.e.e.e.e.e.e.e0e.e.e.e.e.e0e.e0e.e.e.e.e.e1e.e1e.e.e.e.e.e.e0e.e0e.e.e.e1e.e.e.e.e.e.e.e.e.",
        "0e.e.e.e.e.e1e.e0e.e0e.e.e.e0e.e1e.e.e.e.e.e0e.e0e.e.e.e.e.e1e.e1e.e2e.e.e.e.e.e0e.e.e1e.e0e.e2e.e2e..",
        "e.e1e1e.e1e.e.e.e.e.e.e0e.e.e.e.e.e1e.e1e.e.e.e.e.e0e.e1e.e.e.e.e.e.e.e.e1e.e1e.e.e.e.e.e.e.e.e.e.e.e.",
        "...e.e.e.e.e.e0e.e0e.e.e.e0e.e1e.e.e.e.e.e0e.e0e.e.e.e.e.e0e.e0e.e0e.e0e.e.e.e.e.e0e0e.e0e.e2e.e0e.e0.",
        "..e.e.e0e.e1e.e.e.e.e2e.e.e.e.e.e0e.e0e.e.e.e.e.e0e.e0e.e.e.e.e.e.e.e.e.e.e1e.e0e.e.e.e.e.e.e.e.e.e.e.",
        ".e1e2e.e.e.e.e.e0e.e.e.e0e.e1e.e.e.e.e.e0e.e0e.e.e.e.e.e1e.e1e.e0e.e0e.e2e.e.e.e.e.e.e0e.e0e.e0e.e0e..",
        "..e.e.e.e1e.e1e.e.e0e.e.e.e.e.e0e.e0e.e.e.e.e.e1e.e1e.e.e.e.e.e.e.e.e.e.e.e.e0e.e0e0e.e.e.e.e.e.e.e.e.",
        ".e0e.e0e.e.e.e1e.e.e.e0e.e0e.e.e.e.e.e1e.e0e.e.e.e.e.e0e.e0e.e1e.e1e.e1e.e1e.e.e.e.e.e.e1e.e0e.e2e.e0.",
        "..e.e.e.e.e0e.e.e2e.e.e.e.e.e1e.e1e.e.e.e.e.e0e.e1e.e.e.e.e.e.e.e.e.e.e.e.e.e.e0e.e.e0e.e.e.e.e.e.e.e.",
        "...e2e.e1e.e1e.e.e.e0e.e0e.e.e.e.e.e2e.e0e.e.e.e.e.e1e.e0e.e0e.e0e.e0e.e0e.e2e.e.e0e.e.e.e1e.e0e.e0e..",
        "..e.e.e.e.e.e.e0e.e.e.e.e.e1e.e1e.e.e.e.e.e0e.e1e.e.e.e.e.e.e.e.e.e.e.e.e.e.e.e.e.e.e.e0e.e.e.e.e.e.e.",
        ".e2e.e0e.e1e.e.e.e0e.e0e.e.e.e.e.e2e.e0e.e.e.e.e.e0e.e0e.e1e.e0e.e1e.e1e.e0e.e1e1e.e0e.e.e.e1e.e1e.e2.",
        "..e.e.e.e.e.e1e.e.e.e.e.e0e.e0e.e.e.e.e.e0e.e0e.e.e.e.e.e.e.e.e.e.e.e.e.e.e.e.e.e.e.e.e.e0e.e.e.e.e.e.",
        "e0.e0e.e1e.e.e.e0e.e0e.e.e.e.e.e1e.e0e.e.e.e.e.e0e.e0e.e1e.e0e.e0e.e1e.e0e.e0e.e.e1e.e0e.e.e.e1e.e1e..",
        "..e0e.e.e.e1e.e.e.e.e.e2e.e0e.e.e.e.e.e1e.e1e.e.e.e.e.e.e.e.e.e.e.e.e.e.e.e.e.e0e.e.e.e.e.e0e.e.e.e.e.",
        ".e.e.e0e.e.e.e0e.e0e.e.e.e.e.e0e.e0e.e.e.e.e.e0e.e0e.e0e.e0e.e1e.e1e.e0e.e0e.e.e.e.e1e.e1e.e.e.e0e.e0.",
        "e0e.e.e.e1e.e.e.e.e.e0e.e1e.e.e.e.e.e1e.e0e.e.e.e.e.e.e.e.e.e.e.e.e.e.e.e.e.e0e.e2e.e.e.e.e.e0e.e.e.e.",
        "e..e0e.e.e.e1e.e1e.e.e.e.e.e0e.e0e.e.e.e.e.e1e.e1e.e1e.e0e.e1e.e0e.e0e.e1e.e.e.e.e.e.e0e.e1e.e.e.e0e..",
        "1.e.e.e0e.e.e.e.e.e1e.e0e.e.e.e.e.e0e.e0e.e.e.e.e.e.e.e.e.e.e.e.e.e.e.e.e.e0e.e0e.e1e.e.e.e.e.e0e.e.e.",
        "e.0e.e.e.e1e.e1e.e.e.e.e.e0e.e1e.e.e.e.e.e1e.e0e.e1e.e1e.e0e.e0e.e0e.e0e.e.e.e.e.e.e.e.e0e.e0e.e.e.e1.",
        "..e.e1e.e.e.e.e.e0e.e2e.e.e.e.e.e1e.e0e.e.e.e.e.e.e.e.e.e.e.e.e.e.e.e.e.e1e.e1e.e0e.e0e.e.e.e.e.e0e.e.",
        "0e.e.e.e0e.e0e.e.e.e.e.e1e.e0e.e.e.e.e.e0e.e0e.e0e.e0e.e1e.e0e.e1e.e1e.e.e.e.e.e.e.e.e.e.e0e.e0e.e.e..",
        "e.e1e.e.e.e.e.e0e.e1e.e.e.e.e.e0e.e1e.e.e.e.e.e.e.e.e.e.e.e.e.e.e.e.e.e0e.e0e.e0e.e1e.e0e.e.e.e.e.e0e.",
        ".e.e.e0e.e1e.e.e.e.e.e1e.e0e.e.e.e.e.e1e.e0e.e1e.e0e.e0e.e0e.e1e.e0e.e.e.e.e.e.e.e.e.e.e.e.e1e.e1e.e..",
        ".0e.e.e.e.e.e0e.e0e.e.e.e.e.e1e.e1e.e.e.e.e.e.e.e.e.e.e.e.e.e.e.e.e.e0e.e1e.e1e.e0e.e1e.e2e.e.e.e.e.e.",
        ".e.e0e.e0e.e.e.e.e.e0e.e0e.e.e.e.e.e0e.e0e.e0e.e1e.e1e.e0e.e1e.e1e.e.e.e.e.e.e.e.e.e.e.e.e.e.e0e.e0e0.",
        "..e.e.e.e.e0e.e1e.e.e.e.e.e0e.e0e.e.e.e.e.e.e.e.e.e.e.e.e.e.e.e.e.e0e.e1e.e1e.e1e.e1e.e0e.e2e.e.e.e.e.",
        "e.0e.e0e.e.e.e.e.e1e.e0e.e.e.e.e.e0e.e2e.e0e.e0e.e0e.e0e.e1e.e1e.e.e.e.e.e.e.e.e.e.e.e.e.e.e.e.e1e.e..",
        "0.e.e.e.e0e.e2e.e.e.e.e.e0e.e0e.e.e.e.e.e.e.e.e.e.e.e.e.e.e.e.e.e0e.e1e.e2e.e0e.e1e.e1e.e0e.e0e.e.e0e.",
        "e..e0e.e.e.e.e.e0e.e0e.e.e.e.e.e0e.e1e.e0e.e0e.e0e.e0e.e1e.e1e.e.e.e.e.e.e.e.e.e.e.e.e.e.e.e.e.e1e.e..",
        "..e.e.e1e.e0e.e.e.e.e.e0e.e0e.e.e.e.e.e.e.e.e.e.e.e.e.e.e.e.e.e0e.e0e.e1e.e1e.e0e.e0e.e0e.e0e.e.e.e.e.",
        "..1e.e.e.e.e.e1e.e1e.e.e.e.e.e0e.e0e.e0e.e1e.e0e.e0e.e1e.e1e.e.e.e.e.e.e.e.e.e.e.e.e.e.e.e.e.e0e.e0e1.",
        "..e.e1e.e1e.e.e.e.e.e1e.e0e.e.e.e.e.e.e.e.e.e.e.e.e.e.e.e.e.e0e.e1e.e0e.e0e.e1e.e0e.e0e.e1e.e.e.e0e.e.",
        "1e.e.e.e.e.e0e.e0e.e.e.e.e.e1e.e1e.e0e.e0e.e0e.e0e.e0e.e1e.e.e.e.e.e.e.e.e.e.e.e.e.e.e.e.e.e0e.e.e.e..",
        "e.e0e.e1e.e.e.e.e.e1e.e0e.e.e.e.e.e.e.e.e.e.e.e.e.e.e.e.e.e0e.e1e.e0e.e0e.e0e.e0e.e0e.e2e.e.e.e0e.e0e.",
        ".e.e.e.e.e1e.e1e.e.e.e.e.e1e.e0e.e2e.e1e.e0e.e0e.e2e.e0e.e.e.e.e.e.e.e.e.e.e.e.e.e.e.e.e.e1e.e.e.e.e..",
        "e0e.e0e.e.e.e.e.e0e.e1e.e.e.e.e.e.e.e.e.e.e.e.e.e.e.e.e.e1e.e0e.e0e.e0e.e1e.e1e.e1e.e2e.e.e.e0e.e0e.e.",
        ".e.e.e.e1e.e1e.e.e.e.e.e0e.e0e.e0e.e1e.e0e.e0e.e2e.e1e.e.e.e.e.e.e.e.e.e.e.e.e.e.e.e.e.e1e.e.e.e.e.e0.",
        "..e1e.e.e.e.e.e1e.e0e.e.e.e.e.e.e.e.e.e.e.e.e.e.e.e.e.e0e.e0e.e1e.e0e.e0e.e0e.e0e.e0e.e.e.e1e.e1e.e.e.",
        ".e.e.e0e.e0e.e.e.e.e.e0e.e0e.e1e.e0e.e1e.e0e.e0e.e1e.e.e.e.e.e.e.e.e.e.e.e.e.e.e.e.e.e1e.e.e.e.e.e1e..",
        "e0e.e.e.e.e.e0e.e0e.e0e.e.e.e.e.e.e.e.e.e.e.e.e.e.e.e0e.e0e.e2e.e1e.e0e.e0e.e0e.e1e.e.e.e0e.e0e.e.e.e.",
        ".e.e0e.e0e.e.e.e.e.e.e.e1e.e0e.e0e.e0e.e0e.e0e.e1e.e.e.e.e.e.e.e.e.e.e.e.e.e.e.e.e.e0e.e.e.e.e.e0e.e1.",
        "..e.e.e.e.e1e.e2e.e0e.e.e.e.e.e.e.e.e.e.e.e.e.e.e.e0e.e0e.e0e.e0e.e1e.e1e.e0e.e1e.e.e.e0e.e0e.e.e.e.e.",
        ".e2e.e0e.e.e.e.e.e.e.e0e.e0e.e0e.e1e.e1e.e1e.e0e.e.e.e.e.e.e.e.e.e.e.e.e.e.e.e.e.e0e.e.e.e.e.e0e.e1e..",
        "..e.e.e.e1e.e0e.e0e.e.e.e.e.e.e.e.e.e.e.e.e.e.e.e0e.e0e.e1e.e1e.e1e.e1e.e0e.e1e.e.e.e1e.e1e.e.e0e.e.e.",
        "...e0e.e.e.e.e.e.e.e1e.e1e.e1e.e0e.e0e.e1e.e1e.e.e.e.e.e.e.e.e.e.e.e.e.e.e.e.e.e1e.e.e.e.e.e0e.e.e.e0.",
        "..e.e.e0e.e1e.e0e.e.e.e.e.e.e.e.e.e.e.e.e.e.e.e0e.e1e.e1e.e1e.e1e.e1e.e0e.e2e.e.e.e1e.e0e.e.e.e.e1e.e.",
        ".e0e.e.e.e.e.e.e.e1e.e0e.e0e.e1e.e2e.e2e.e1e.e.e.e.e.e.e.e.e.e.e.e.e.e.e.e.e.e1e.e.e.e.e.e0e.e0e.e.e..",
        "0.e.e0e.e1e.e1e.e.e.e.e.e.e.e.e.e.e.e.e.e.e.e0e.e1e.e0e.e0e.e0e.e1e.e1e.e0e.e.e.e1e.e0e.e.e.e.e.e.e0e.",
        "e..e.e.e.e.e.e.e0e.e0e.e1e.e0e.e1e.e1e.e1e.e.e.e.e.e.e.e.e.e.e.e.e.e.e.e.e.e0e.e.e.e.e.e1e.e1e.e0e.e..",
        "..e0e.e0e.e0e.e.e.e.e.e.e.e.e.e.e.e.e.e.e.e1e.e0e.e0e.e0e.e1e.e1e.e0e.e0e.e.e.e1e.e0e.e.e.e.e.e.e.e0e.",
        "...e.e.e.e.e.e1e.e0e.e0e.e1e.e0e.e1e.e0e.e.e.e.e.e.e.e.e.e.e.e.e.e.e.e.e.e1e.e.e.e.e.e1e.e1e.e0e.e.e..",
        "e0e.e0e.e0e1e.e.e.e.e.e.e.e.e.e.e.e.e.e.e1e.e0e.e0e.e1e.e0e.e1e.e1e.e0e.e.e.e1e.e1e.e.e.e.e.e.e.e1e.e.",
        ".e.e.e.e.e.e.e.e1e.e0e.e0e.e1e.e2e.e0e.e.e.e.e.e.e.e.e.e.e.e.e.e.e.e.e.e1e.e.e.e.e.e1e.e1e.e0e.e.e.e1.",
        "e.e0e.e2e.e.e0e.e.e.e.e.e.e.e.e.e.e.e.e1e.e1e.e0e.e1e.e0e.e0e.e1e.e1e.e.e.e1e.e1e.e.e.e.e.e.e.e1e.e.e.",
        "0e.e.e.e.e1e.e.e.e1e.e0e.e1e.e0e.e1e.e.e.e.e.e.e.e.e.e.e.e.e.e.e.e.e.e0e.e.e.e.e.e0e.e0e.e2e.e.e.e1e..",
        "..e.e0e.e.e.e.e2e.e.e.e.e.e.e.e.e.e.e1e.e0e.e0e.e0e.e0e.e1e.e1e.e0e.e.e.e1e.e0e.e.e.e.e.e.e.e1e.e.e.e.",
        ".e0e.e.e1e.e2e.e.e.e0e.e0e.e0e.e0e.e.e.e.e.e.e.e.e.e.e.e.e.e.e.e.e.e0e.e.e.e.e.e1e.e0e.e0e.e.e.e0e.e0.",
        "..e.e.e.e.e.e.e.e0e.e.e.e.e.e.e.e.e0e.e0e.e1e.e1e.e1e.e0e.e0e.e0e.e.e.e0e.e1e.e.e.e.e.e.e.e0e.e.e.e.e.",
        "0e.e0e0e.e0e.e0e.e.e.e1e.e1e.e0e.e.e.e.e.e.e.e.e.e.e.e.e.e.e.e.e.e2e.e.e.e.e.e0e.e0e.e0e.e.e.e1e.e1e..",
        "e.e.e.e.e.e.e.e.e.e2e.e.e.e.e.e.e0e.e0e.e0e.e0e.e1e.e0e.e2e.e2e.e.e.e0e.e0e.e.e.e.e.e.e.e2e.e.e.e.e.e.",
        "ee0e.e.e1e.e0e.e0e.e.e.e1e.e0e.e.e.e.e.e.e.e.e.e.e.e.e.e.e.e.e.e2e.e.e.e.e.e0e.e0e.e1e.e.e.e1e.e0e.e0.",
        "0.e.e0e.e.e.e.e.e.e.e0e.e.e.e.e1e.e1e.e1e.e0e.e0e.e0e.e1e.e2e.e.e.e0e.e0e.e.e.e.e.e.e.e0e.e.e.e.e.e.e.",
        "e..e.e.e.e1e.e0e.e0e.e.e.e0e.e.e.e.e.e.e.e.e.e.e.e.e.e.e.e.e.e0e.e.e.e.e.e0e.e0e.e0e.e.e.e1e.e0e.e1e..",
        "..e2e.e0e.e.e.e.e.e.e.e0e.e.e0e.e1e.e0e.e0e.e0e.e1e.e0e.e0e.e.e.e1e.e1e.e.e.e.e.e.e.e0e.e.e.e.e.e.e.e.",
        ".e.e.e.e.e.e0e.e0e.e0e.e.e.e.e.e.e.e.e.e.e.e.e.e.e.e.e.e.e.e1e.e.e.e.e.e1e.e0e.e1e.e.e.e1e.e2e.e1e.e0.",
        "e2e.e0e.e0e.e.e.e.e.e.e.e0e0e.e0e.e0e.e1e.e1e.e0e.e0e.e2e.e.e.e0e.e0e.e.e.e.e.e.e.e0e.e.e.e.e.e.e.e.e.",
        "ee...e.e.e.e.e0e.e0e.e0e.e.e.e.e.e.e.e.e.e.e.e.e.e.e.e.e.e1e.e.e.e.e.e0e.e0e.e0e.e.e.e1e.e0e.e1e.e0e..",
        "0e.e..e0e.e0e.e.e.e.e.e.e.e.e1e.e0e.e0e.e1e.e0e.e0e.e1e.e.e.e1e.e0e.e.e.e.e.e.e.e1e.e.e.e.e.e.e.e.e.e.",
        "e.e0.e.e.e.e.e.e0e.e1e.e1e0e.e.e.e.e.e.e.e.e.e.e.e.e.e.e0e.e.e.e.e.e1e.e0e.e0e.e.e.e0e.e0e.e1e.e0e.e0.",
        ".e.e.0e.e0e.e0e.e.e.e.e.e.e.e.e1e.e0e.e1e.e0e.e0e.e0e.e.e.e0e.e0e.e.e.e.e.e.e.e0e.e.e.e.e.e.e.e.e.e.e.",
        "e2e..e.e.e.e.e.e.e0e.e0e.e.e0e.e.e.e.e.e.e.e.e.e.e.e.e1e.e.e.e.e.e0e.e1e.e0e.e.e.e0e.e0e.e1e.e1e.e1e..",
        ".e0e..e0e.e0e.e0e.e.e.e.e0e.e.e.e1e.e1e.e0e.e1e.e0e.e.e.e1e.e0e.e.e.e.e.e.e.e1e.e.e.e.e.e.e.e.e.e.e.e.",
        "..e..e.e.e.e.e.e.e.e0e.e.e.e.e0e.e.e.e.e.e.e.e.e.e.e1e.e.e.e.e.e1e.e0e.e0e.e0e.e1e.e1e.e0e.e1e.e1e.e0.",
        "...e.0e.e2e.e1e.e0e.e.e0e.e1e.e.e.e1e.e0e.e0e.e0e.e.e.e0e.e0e.e.e.e.e.e.e.e.e.e.e.e.e.e.e.e.e.e.e.e.e.",
        "..e0.e.e.e.e.e.e.e.e0e.e.e.e.e.e0e.e.e.e.e.e.e.e.e0e.e.e.e.e.e0e.e0e.e0e.e0e.e0e.e0e.e1e.e0e.e0e.e1e..",
        "...e..e2e.e0e.e0e.e.e.e.e1e.e0e.e.e.e1e.e1e.e1e.e.e.e0e.e1e.e.e.e.e.e.e.e.e.e.e.e.e.e.e.e.e.e.e.e.e.e.",
        "..1..e.e.e.e.e.e.e2e.e2e.e.e.e.e.e2e.e.e.e.e.e.e1e.e.e.e.e.e0e.e0e.e1e.e1e.e0e.e1e.e0e.e0e.e0e.e1e.e0.",
        "..e..0e.e0e.e0e.e.e.e.e.e.e0e.e2e.e.e.e1e.e1e.e.e.e1e.e1e.e.e.e.e.e.e.e.e.e.e.e.e.e.e.e.e.e.e.e.e.e.e.",
        "..1..e.e.e.e.e.e0e.e0e.e1e.e.e.e.e.e1e.e.e.e.e0e.e.e.e.e.e0e.e0e.e1e.e0e.e2e.e1e.e0e.e0e.e1e.e1e.e1e..",
        ".e0e..e0e.e0e.e.e.e.e.e.e.e.e0e.e0e.e.e.e0e.e.e.e2e.e1e.e.e.e.e.e.e.e.e.e.e.e.e.e.e.e.e.e.e.e.e.e.e.e.",
        "..e..e.e.e.e.e0e.e0e.e0e.e0e.e.e.e.e.e0e.e.e0e.e.e.e.e.e0e.e1e.e0e.e2e.e1e.e0e.e0e.e0e.e0e.e0e.e0e.e1.",
        ".e0e.2e.e0e.e.e.e.e.e.e.e.e.e.e0e.e0e.e.e1e.e.e1e.e1e.e.e.e.e.e.e.e.e.e.e.e.e.e.e.e.e.e.e.e.e.e.e.e.e.",
        "..e..e.e.e.e0e.e0e.e0e.e0e.e0e.e.e.e.e1e.e.e.e.e.e.e.e0e.e0e.e1e.e0e.e0e.e0e.e1e.e0e.e0e.e0e.e2e.e0e..",
        "...e..e0e.e.e.e.e.e.e.e.e.e.e.e.e0e.e.e.e.e0e1e1e0e.e.e.e.e.e.e.e.e.e.e.e.e.e.e.e.e.e.e.e.e.e.e.e.e.e.",
        "..e0...e.e0e.e0e.e0e.e0e.e0e.e1e.e.e0e.e0e.e.e.e.e.e1e.e0e.e0e.e0e.e0e.e0e.e0e.e0e.e1e.e0e.e1e.e0e.e0.",
        "0e...................................................................................................."
    ],
    "weight": false,
    "n_row": 101,
    "n_col": 102,
    "repair_time": 23846.298132658005
}