{
    "name": "kiva_large_seed_block",
    "weight": false,
    "n_row": 21,
    "n_col": 21,
    "n_endpoint": 40,
    "n_agent_loc": 40,
    "maxtime": 5000,
    "layout": [
        ".....................",
        ".....................",
        ".....................",
        ".....................",
        ".....................",
        ".....................",
        ".....................",
        ".....................",
        ".....................",
        ".........ee..........",
        ".........@@..........",
        ".........ee..........",
        ".....................",
        ".....................",
        ".....................",
        ".....................",
        ".....................",
        ".....................",
        ".....................",
        ".....................",
        "....................."
    ]
}