{
    "name": "kiva_xxlarge_seed_block",
    "weight": false,
    "n_row": 101,
    "n_col": 98,
    "n_endpoint": 40,
    "n_agent_loc": 40,
    "maxtime": 5000,
    "layout": [
        "..................................................................................................",
        "..................................................................................................",
        "..................................................................................................",
        "..................................................................................................",
        "..................................................................................................",
        "..................................................................................................",
        "..................................................................................................",
        "..................................................................................................",
        "..................................................................................................",
        "..................................................................................................",
        "..................................................................................................",
        "..................................................................................................",
        "..................................................................................................",
        "..................................................................................................",
        "..................................................................................................",
        "..................................................................................................",
        "..................................................................................................",
        "..................................................................................................",
        "..................................................................................................",
        "..................................................................................................",
        "..................................................................................................",
        "..................................................................................................",
        "..................................................................................................",
        "..................................................................................................",
        "..................................................................................................",
        "..................................................................................................",
        "..................................................................................................",
        "..................................................................................................",
        "..................................................................................................",
        "..................................................................................................",
        "..................................................................................................",
        "..................................................................................................",
        "..................................................................................................",
        "..................................................................................................",
        "..................................................................................................",
        "..................................................................................................",
        "..................................................................................................",
        "..................................................................................................",
        "..................................................................................................",
        "..................................................................................................",
        "..................................................................................................",
        "..................................................................................................",
        "..................................................................................................",
        "..................................................................................................",
        "..................................................................................................",
        "..................................................................................................",
        "..................................................................................................",
        "..................................................................................................",
        "..................................................................................................",
        "..................................................................................................",
        "................................................ee................................................",
        "................................................@@................................................",
        "................................................ee................................................",
        "..................................................................................................",
        "..................................................................................................",
        "..................................................................................................",
        "..................................................................................................",
        "..................................................................................................",
        "..................................................................................................",
        "..................................................................................................",
        "..................................................................................................",
        "..................................................................................................",
        "..................................................................................................",
        "..................................................................................................",
        "..................................................................................................",
        "..................................................................................................",
        "..................................................................................................",
        "..................................................................................................",
        "..................................................................................................",
        "..................................................................................................",
        "..................................................................................................",
        "..................................................................................................",
        "..................................................................................................",
        "..................................................................................................",
        "..................................................................................................",
        "..................................................................................................",
        "..................................................................................................",
        "..................................................................................................",
        "..................................................................................................",
        "..................................................................................................",
        "..................................................................................................",
        "..................................................................................................",
        "..................................................................................................",
        "..................................................................................................",
        "..................................................................................................",
        "..................................................................................................",
        "..................................................................................................",
        "..................................................................................................",
        "..................................................................................................",
        "..................................................................................................",
        "..................................................................................................",
        "..................................................................................................",
        "..................................................................................................",
        "..................................................................................................",
        "..................................................................................................",
        "..................................................................................................",
        "..................................................................................................",
        "..................................................................................................",
        "..................................................................................................",
        "..................................................................................................",
        ".................................................................................................."
    ]
}