{
    "name": "kiva_57x54_seed_block",
    "weight": false,
    "n_row": 57,
    "n_col": 54,
    "n_endpoint": 40,
    "n_agent_loc": 40,
    "maxtime": 5000,
    "layout": [
        "......................................................",
        "......................................................",
        "......................................................",
        "......................................................",
        "......................................................",
        "......................................................",
        "......................................................",
        "......................................................",
        "......................................................",
        "......................................................",
        "......................................................",
        "......................................................",
        "......................................................",
        "......................................................",
        "......................................................",
        "......................................................",
        "......................................................",
        "......................................................",
        "......................................................",
        "......................................................",
        "......................................................",
        "......................................................",
        "......................................................",
        "......................................................",
        "......................................................",
        "......................................................",
        "......................................................",
        "..........................ee..........................",
        "..........................@@..........................",
        "..........................ee..........................",
        "......................................................",
        "......................................................",
        "......................................................",
        "......................................................",
        "......................................................",
        "......................................................",
        "......................................................",
        "......................................................",
        "......................................................",
        "......................................................",
        "......................................................",
        "......................................................",
        "......................................................",
        "......................................................",
        "......................................................",
        "......................................................",
        "......................................................",
        "......................................................",
        "......................................................",
        "......................................................",
        "......................................................",
        "......................................................",
        "......................................................",
        "......................................................",
        "......................................................",
        "......................................................",
        "......................................................"
    ]
}