{
    "name": "kiva_81x76_seed_block",
    "weight": false,
    "n_row": 81,
    "n_col": 76,
    "n_endpoint": 40,
    "n_agent_loc": 40,
    "maxtime": 5000,
    "layout": [
        "............................................................................",
        "............................................................................",
        "............................................................................",
        "............................................................................",
        "............................................................................",
        "............................................................................",
        "............................................................................",
        "............................................................................",
        "............................................................................",
        "............................................................................",
        "............................................................................",
        "............................................................................",
        "............................................................................",
        "............................................................................",
        "............................................................................",
        "............................................................................",
        "............................................................................",
        "............................................................................",
        "............................................................................",
        "............................................................................",
        "............................................................................",
        "............................................................................",
        "............................................................................",
        "............................................................................",
        "............................................................................",
        "............................................................................",
        "............................................................................",
        "............................................................................",
        "............................................................................",
        "............................................................................",
        "............................................................................",
        "............................................................................",
        "............................................................................",
        "............................................................................",
        "............................................................................",
        "............................................................................",
        "............................................................................",
        "............................................................................",
        "............................................................................",
        ".....................................ee.....................................",
        ".....................................@@.....................................",
        ".....................................ee.....................................",
        "............................................................................",
        "............................................................................",
        "............................................................................",
        "............................................................................",
        "............................................................................",
        "............................................................................",
        "............................................................................",
        "............................................................................",
        "............................................................................",
        "............................................................................",
        "............................................................................",
        "............................................................................",
        "............................................................................",
        "............................................................................",
        "............................................................................",
        "............................................................................",
        "............................................................................",
        "............................................................................",
        "............................................................................",
        "............................................................................",
        "............................................................................",
        "............................................................................",
        "............................................................................",
        "............................................................................",
        "............................................................................",
        "............................................................................",
        "............................................................................",
        "............................................................................",
        "............................................................................",
        "............................................................................",
        "............................................................................",
        "............................................................................",
        "............................................................................",
        "............................................................................",
        "............................................................................",
        "............................................................................",
        "............................................................................",
        "............................................................................",
        "............................................................................"
    ]
}