{
    "name": "kiva_mid_seed_block",
    "weight": false,
    "n_row": 17,
    "n_col": 12,
    "n_endpoint": 40,
    "n_agent_loc": 40,
    "maxtime": 5000,
    "layout": [
        "............",
        "............",
        "............",
        "............",
        "............",
        "............",
        "............",
        ".....ee.....",
        ".....@@.....",
        ".....ee.....",
        "............",
        "............",
        "............",
        "............",
        "............",
        "............",
        "............"
    ]
}