{
    "name": "kiva_69x65_seed_block",
    "weight": false,
    "n_row": 69,
    "n_col": 65,
    "n_endpoint": 40,
    "n_agent_loc": 40,
    "maxtime": 5000,
    "layout": [
        ".................................................................",
        ".................................................................",
        ".................................................................",
        ".................................................................",
        ".................................................................",
        ".................................................................",
        ".................................................................",
        ".................................................................",
        ".................................................................",
        ".................................................................",
        ".................................................................",
        ".................................................................",
        ".................................................................",
        ".................................................................",
        ".................................................................",
        ".................................................................",
        ".................................................................",
        ".................................................................",
        ".................................................................",
        ".................................................................",
        ".................................................................",
        ".................................................................",
        ".................................................................",
        ".................................................................",
        ".................................................................",
        ".................................................................",
        ".................................................................",
        ".................................................................",
        ".................................................................",
        ".................................................................",
        ".................................................................",
        ".................................................................",
        ".................................................................",
        "...............................ee................................",
        "...............................@@................................",
        "...............................ee................................",
        ".................................................................",
        ".................................................................",
        ".................................................................",
        ".................................................................",
        ".................................................................",
        ".................................................................",
        ".................................................................",
        ".................................................................",
        ".................................................................",
        ".................................................................",
        ".................................................................",
        ".................................................................",
        ".................................................................",
        ".................................................................",
        ".................................................................",
        ".................................................................",
        ".................................................................",
        ".................................................................",
        ".................................................................",
        ".................................................................",
        ".................................................................",
        ".................................................................",
        ".................................................................",
        ".................................................................",
        ".................................................................",
        ".................................................................",
        ".................................................................",
        ".................................................................",
        ".................................................................",
        ".................................................................",
        ".................................................................",
        ".................................................................",
        "................................................................."
    ]
}