9,16
36
36
5000
............e...
w.@eeee@e@e.@e.w
..ee@@ee@e@ee...
..........e@@e..
w.@eee@ee@ee@e.w
..e.@.e@@e..e@..
......e@e@......
w..e@..e.e.....w
...e@e..........