{
    "name": "kiva_large_200_agents_cma-mae_opt_entropy_uneven_throughput_hamming_a=1",
    "weight": false,
    "n_row": 33,
    "n_col": 36,
    "n_endpoint": 230,
    "n_agent_loc": 0,
    "maxtime": 5000,
    "layout": [
        "....................................",
        "w.e@e@e@e@e@e@e@e@e@e@e@e@e@e@e@e@.w",
        "....................................",
        "..e@e@e@e@e@e@e@e@e@.@e@....@e@@e...",
        "w..................................w",
        "..e@e@e@e@e@e@e@ee@@e@@e@@e@@e@@e@..",
        "....................................",
        "w.e@e@e@e@e@e@e@e@e@e@e@@e@e@e@@e@.w",
        "....................................",
        "..e@e.e@e@e@e@e@e@e@e@@e@e@e@ee@@e..",
        "w..................................w",
        "..e@e.e@e.e@e@e@e@e@e@e@@e@e@e@e@...",
        "....................................",
        "w.e@e...@e@@e@e@e@e@e@e@@e@e@e@e@..w",
        "....................................",
        "..e@e.e@e.e@e@e@e@e@e@e@e@@e@...@e..",
        "w..................................w",
        "..e@e.e@e@e@e@...@e@e@e@ee@e@..@e@..",
        "....................................",
        "w.e@e.e@e@@e@.@e@@e@e@e@e@e@e@e@e@.w",
        "....................................",
        "..e@e.e@e@@e@e@e@..@e@e@e@e@e@e@e@..",
        "w..................................w",
        "..e@e.e@e@@e@e@e@e@@e@e@.e@@e@e@e@..",
        "....................................",
        "w.e@e.e@ee@ee@@e@e@@e@e@@e@e@e@ee@.w",
        "....................................",
        "..e@e.e@e.e@e@e@e@e@e@e@e@@e@e@e@...",
        "w..................................w",
        "..e@e.e@e.e@e@e@e@e@e@e@e@@e@.@e@...",
        "....................................",
        "w.e@e.e@e.e@e@e@e@e@e@e@e@@e@@e@@e.w",
        "...................................."
    ]
}