{
    "name": "kiva_large_200_agents_cma-mae_opt_entropy",
    "layout": [
        "..e@@e@@e@@e@@e@@e@@e@@e@@e@@e@@e@..",
        "w.e................................w",
        "..@@e@.@e@@e@@e@@e@@e@@e@@e@@e@@e@..",
        "..e.................................",
        "w.e@@@e@@@e@@@e@@@e@@@e@@e@.e@@.@..w",
        "..e.e.e.e.e.e.e.e.e.e.e.e.....e.e...",
        "..@.@.@.@.@.@.@.@.@.@.@.@.@e@.@.@...",
        "w.e.e.e.e.e.e.e....................w",
        "..e.@.@.@.@.@.@e@e@@e@@e@@e@@e@@e@..",
        "..@.e.e.e.e.e.e.....................",
        "w.e.@.@.@.@.@.@.e@@e@e@@e@@e@ee@.@.w",
        "..e.e.e.e.e.e.e.e.e.......e......e..",
        "..@.@.@.@.@.@.@.@.@.@@e.@.@e.@......",
        "w.e.e.e.e.e.e.e.e.e.e.e.e.e.ee.....w",
        "..e.@.@.@.@.@.@.@.@.@.@.@.@.@.e.....",
        "..@.e.e.e.e.e.e.e.e.e.e.e.e.e.@.@...",
        "w.e.e.e.e.e.e.e.e.e.e.e.e.e.e.e.e..w",
        "..e.@.@.@.@.@.@.@.@.@.@.@.@.@.@.@...",
        "..@.e.e.e.e.e.e.e.e.e.e.e.e.e.e.e...",
        "w.e.@.@.@.@.@.@.@.@.@.@.@.@.@.@.@..w",
        "..e.e.e.e.e.e.e.e.e.e.e.e.e.e.e.e...",
        "..@.e.e.@.@.@.@.@.@.@.@.@.@.@.@.@...",
        "w.e.@.@.e.e.e.e.e.e.e.e.e.e.e.e.e..w",
        "..e.e.e.e.e.e.e.e.e.e.e.e.e.e.e.e...",
        "..@.e@e.@.@.@.@.@.@.@.@.@.@.@.@.@e..",
        "w..@ee.e..e.e.e.e.e.e.e.e.e........w",
        "..eee.e@ee@e@.@.@.@.@.@...@.@.@.....",
        "..@.@...@.e...............e.e.e.e...",
        "w.e.@...e.................@.@.@.@..w",
        "..e.e.e.e...........................",
        "..@.@.@.@e@...................@e@...",
        "w.....e.e..............@.@.@.......w",
        "..e@e...@..............e.e.e.@e@...."
    ],
    "nca_runtime": null,
    "milp_runtime": null,
    "nca_milp_runtime": null,
    "weight": false,
    "n_row": 33,
    "n_col": 36,
    "n_endpoint": 242,
    "n_agent_loc": 0,
    "maxtime": 5000
}