{
    "name": "kiva_large_200_agents_cma-mae_opt_entropy_throughput_hamming_a=5",
    "weight": false,
    "n_row": 33,
    "n_col": 36,
    "n_endpoint": 249,
    "n_agent_loc": 0,
    "maxtime": 5000,
    "layout": [
        "....................................",
        "w.e@ee@@ee@@ee@@ee@@ee@@ee@@ee@.e@.w",
        "....................................",
        "...@ee@@ee@@ee@@ee@@ee@@ee@@ee@@e...",
        "w..................................w",
        "...@ee@@ee@@ee@@ee@@ee@@ee@@ee@.e@..",
        "....................................",
        "w.e@ee@@ee@@ee@@ee@@ee@@ee@@ee@@e@.w",
        "....................................",
        "..e@ee@@ee@@ee@@ee@@ee@@ee@@ee@@e...",
        "w..................................w",
        "..e@ee@@ee@@ee@@ee@@ee@@ee@@ee@ee@..",
        "....................................",
        "w..@ee@@ee@@ee@@ee@@ee@@ee@@ee@ee@.w",
        "....................................",
        "..@ee@@e.e@@ee@@ee@@ee@@ee@@ee@@e...",
        "w..................................w",
        "..@ee@@ee@.@ee@@ee@@ee@@ee@@ee@@e...",
        "....................................",
        "w.@ee@@ee@@e.e@@ee@@ee@@ee@@ee@@e..w",
        "....................................",
        "..@ee@@ee@@e.e@@ee@@ee@@ee@@ee@@e...",
        "w..................................w",
        "..@ee@@ee@@e.e@@ee@@ee@@ee@@ee@ee@..",
        "....................................",
        "w.@ee@@ee@@ee@e@ee@@ee@@ee@@ee@.e@.w",
        "....................................",
        "..@ee@@ee@@ee@@e.e@@ee@@ee@@ee@ee@..",
        "w..................................w",
        "..@ee@@ee@@ee@e@ee@@ee@@ee@@ee@.e@..",
        "....................................",
        "w...e@@ee@@ee@.@ee@@ee@@ee@@ee@@e..w",
        "...................................."
    ]
}