{
    "name": "kiva_large_200_agents_cma-mae_opt_entropy_uneven",
    "weight": false,
    "n_row": 33,
    "n_col": 36,
    "n_endpoint": 201,
    "n_agent_loc": 0,
    "maxtime": 5000,
    "layout": [
        "...e.e.e.e@@e@@e@e@@e@@e@@e@@e@@e@..",
        "w..@.@.@...........................w",
        "...e.e.e.........................e..",
        "...e.e.e.@e@@e@@e@@e@@e@@e@@e@@e@@..",
        "w..@.@.@...........................w",
        "...e.e.e.e@@.....................e..",
        "...e.e.e.e.e.e@@e@@e@@e@@e@@e@@e@@..",
        "w..@.@.@.@.........................w",
        "...e.e.e.e.e.e@@....................",
        ".....e...e.@.e.e.e@@e@@e@@e@@e@@e...",
        "w..e.@.e.@.e.@.e...................w",
        "...@.e.@.e...e.@.e@e@@e@@e@@e@@e@...",
        "...e.e.e.e.e.e.e.e..................",
        "w..e.@.e.@.@.@.e.@.@e@@e@@e@@e@@e@.w",
        "...@.e.@.e.e.e.@.e..................",
        "...e.e.e...e.e.e.e.@e@@e@@e@@e@@e@..",
        "w..e.@.e.e.@.@...@.................w",
        "...@.e.@.@.e.e.e.e@@e@@e@@e@@e@@e@..",
        "...e.e.e.e.e...@....................",
        "w....@.e.e.@.e.e.e@@e@@e@@e@@e@@e@.w",
        "...e.e.@.@.e.@......................",
        "...@.e.e.e.e.e.@e@.@e@@e@@e@@e@@e@..",
        "w..e.@.e...@.......................w",
        "...e.e.@.e.e....@e@@e@@e@@e@@e@@e@..",
        "...@.e.e.@..........................",
        "w..e.@.e.e...e@.@e@@e@@e@@e@@e@@e@.w",
        "...e.e.@............................",
        "...@.e.e..e@.@e@@e@@e@@e@@e@@e@@e@..",
        "w..e.@.............................w",
        "...e.e......@e@.@e@@e@@e@@e@@e@@e@..",
        "...@................................",
        "w..e...........@e@.@e@@e@@e@@e@@e@.w",
        "...................................."
    ]
}