{
    "name": "kiva_large_200_agents_cma-mae_opt_avg_turn",
    "weight": false,
    "n_row": 33,
    "n_col": 36,
    "n_endpoint": 256,
    "n_agent_loc": 0,
    "maxtime": 5000,
    "layout": [
        "....................................",
        "w..e@e@e@e@e@e@e@e@e@e@e@e@e@e@e@e.w",
        "....................................",
        "...e@e@e@e@e@e@e@e@e@e@e@e@e@e@e@e..",
        "w..................................w",
        "...e@e@e@e@e@e@e@e@e@e@e@e@e@e@e@e..",
        "....................................",
        "w..e@e@e@e@e@e@e@e@e@e@e@e@e@e@e@e.w",
        "....................................",
        "...e@e@e@e@e@e@e@e@e@e@e@e@e@e@e@e..",
        "w..................................w",
        "...e@e@e@e@e@e@e@e@e@e@e@e@e@e@e@e..",
        "....................................",
        "w..e@e@e@e@e@e@e@e@e@e@e@e@e@e@e@e.w",
        "....................................",
        "...e@e@e@e@e@e@e@e@e@e@e@e@e@e@e@e..",
        "w..................................w",
        "...e@e@e@e@e@e@e@e@e@e@e@e@e@e@e@e..",
        "....................................",
        "w..e@e@e@e@e@e@e@e@e@e@e@e@e@e@e@e.w",
        "....................................",
        "...e@e@e@e@e@e@e@e@e@e@e@e@e@e@e@e..",
        "w..................................w",
        "...e@e@e@e@e@e@e@e@e@e@e@e@e@e@e@e..",
        "....................................",
        "w..e@e@e@e@e@e@e@e@e@e@e@e@e@e@e@e.w",
        "....................................",
        "...e@e@e@e@e@e@e@e@e@e@e@e@e@e@e@e..",
        "w..................................w",
        "...e@e@e@e@e@e@e@e@e@e@e@e@e@e@e@e..",
        "....................................",
        "w.e@e@e@e@e@e@e@e@e@e@e@e@e@e@e@e..w",
        "...................................."
    ]
}