{
    "name": "kiva_large_200_agents_cma-mae_opt_entropy_throughput_hamming_a=1",
    "weight": false,
    "n_row": 33,
    "n_col": 36,
    "n_endpoint": 242,
    "n_agent_loc": 0,
    "maxtime": 5000,
    "layout": [
        "....................................",
        "w.@e@@e@@e@@e@@e@@e@@@e@@e@@e@@@@e.w",
        "....................e.........ee....",
        "..@e@@e@@e@@e@@e@@e@@@e@@e@@@@@@@e..",
        "w..........................eee.....w",
        "..@e@@e@@e@@e@@e@@e@@e@@e@@@@@@@@...",
        "..........................e...eee...",
        "w.e@ee@@e@@e@@e@@e@@@e@@e@@@e@@@@..w",
        "...................e................",
        "..e@ee@ee@ee@@e@@e@@@ee@ee@ee@ee@e..",
        "w..................................w",
        "..e@ee@ee@ee@@e@@e@@e@@e@@@e@@@e@...",
        "................@........e...e......",
        "w.e@eee@ee@@e@@eee@@e@@e@@@e@@@e@..w",
        ".....@..............................",
        "..e@eee@ee@ee@ee@ee@ee@ee@ee@ee@@e..",
        "w..................................w",
        "..e@ee@ee@ee@eee@ee@ee@ee@ee@eee@e..",
        "..............@...............@.....",
        "w.e@ee@ee@ee@eee@ee@ee@ee@ee@eee@e.w",
        "....................................",
        "..e@ee@ee@ee@ee@ee@ee@ee@ee@ee@ee@..",
        "w..................................w",
        "..e@ee@ee@ee@ee@ee@ee@ee@ee@ee@ee@..",
        "....................................",
        "w.e@ee@ee@ee@ee@ee@ee@ee@ee@ee@ee@.w",
        "....................................",
        "..e@ee@ee@ee@ee@ee@ee@ee@eee@eee@e..",
        "w.........................@...@....w",
        "..e@ee@ee@ee@ee@ee@ee@ee@eee@eee@e..",
        "....................................",
        "w.e@ee@ee@ee@ee@ee@e@@ee@ee@ee@e@e.w",
        "...................................."
    ]
}