{
    "name": "kiva_large_200_agents_cma-mae_opt_entropy_uneven_throughput_hamming_a=5",
    "weight": false,
    "n_row": 33,
    "n_col": 36,
    "n_endpoint": 267,
    "n_agent_loc": 0,
    "maxtime": 5000,
    "layout": [
        "...e.............................@..",
        "w..@.@.@.@.@.@.@.@.@.@.@.@.@..e@@e.w",
        "...e.e.e.e.e.e.e.e.e.e.e.e.e@.@e@@..",
        "...@.e@e.e.@.e.e.e.@......ee........",
        "w..e.e@e.@.e.@.@.@.e.@e@e@@@@e@@e@.w",
        "...e.e.e.e.e.e.e.e.e................",
        "...@.@.@.@.@.e.e.e.@.@e@@e@@e@@e@@..",
        "w..e.e.e.e.e.@.@.@.e.e...........e.w",
        "...e.e.e.e.e.e.e.e.e.e@@e@@e@@e@@@..",
        "...@.@.@.@.@.e.e.e.@.e..........e...",
        "w..e.e.e.e.e.@.@.@.e.@.@e@@e@@e@@@.w",
        "...e.e.e.e.e.e.e.e.e.e...........e..",
        "...@.@.@.@.@.e.e.e.@.e.@e@@.@.@.@@..",
        "w..e.e.e.e.e.@.@.@.e.@....e.e.e.e..w",
        "...@.e.e.e.e.e.e.e.e.e.@@.@.@.@.@...",
        "...e.@.@.@.@.e.e.e.@.e.ee.e.e.e.e...",
        "w..e.e.e.e.e.@.@.@.e.@.ee@e.e.@.e..w",
        "...@.e.e.e.e.e.e.e.e.e.@..e.@.e.@...",
        "...e.@.@.@.@.e.e.e.@.e.e..@.e.e.e...",
        "w..e.e.e.e.e.@.@.@.e.@.@e.e.e.@.e..w",
        "...@.e.e.e.e.e.e.e.e.e....e.@.e.@...",
        "...e.@.@.@.@.e.e@e.@.@@@e@@.e.e.e...",
        "w..e.e.e.e.e.@.e......e.....e.@.e..w",
        "...@.e.e.e.e.e.@.e@@e@@@e@@.@.e.@...",
        "...e.@.@.@.@.e.e.e........e...e.....",
        "w..e.e.e.e.e.@.e@@e@@e@@e@@@e@@@@..w",
        "...@.e.e.......................eee..",
        "...e.@.@.e@@e@@e@@e@@@e@@e@@@e@@@@..",
        "w..e.e.e.e@.........e......e.......w",
        "...@.e.e...@e@@e@@e@@@e@@e@@@e@@@@..",
        "...e.@.@.e.....................eee..",
        "w.@e.e.e.@@e@@e@@e@@e@@e@@e@@e@@@@.w",
        "...................................."
    ]
}