{
    "name": "kiva_large_200_agents_cma-mae_opt_entropy_throughput_hamming_a=5_unrepaired",
    "layout": [
        "....................................",
        "w.e@ee@@ee@@ee@@ee@@ee@@ee@@ee@@e@.w",
        "....................................",
        "..@@ee@@ee@@ee@@ee@@ee@@ee@@ee@@e@..",
        "w..................................w",
        "..@@ee@@ee@@ee@@ee@@ee@@ee@@ee@@e@..",
        "....................................",
        "w.@@ee@@ee@@ee@@ee@@ee@@ee@@ee@@e@.w",
        "....................................",
        "..@@ee@@ee@@ee@@ee@@ee@@ee@@ee@@e@..",
        "w..................................w",
        "..@@ee@@ee@@ee@@ee@@ee@@ee@@ee@@e@..",
        "....................................",
        "w.@@ee@@ee@@ee@@ee@@ee@@ee@@ee@@e@.w",
        "....................................",
        "..@ee@@eee@@ee@@ee@@ee@@ee@@ee@@e@..",
        "w..................................w",
        "..@ee@@ee@@@ee@@ee@@ee@@ee@@ee@@e@..",
        "....................................",
        "w.@ee@@ee@@eee@@ee@@ee@@ee@@ee@@e@.w",
        "....................................",
        "..@ee@@ee@@eee@@ee@@ee@@ee@@ee@@e@..",
        "w..................................w",
        "..@ee@@ee@@eee@@ee@@ee@@ee@@ee@@e@..",
        "....................................",
        "w.@ee@@ee@@ee@@@ee@@ee@@ee@@ee@@e@.w",
        "....................................",
        "..@ee@@ee@@ee@@eee@@ee@@ee@@ee@@e@..",
        "w..................................w",
        "..@ee@@ee@@ee@@@ee@@ee@@ee@@ee@@e@..",
        "....................................",
        "w.eee@@ee@@ee@@@ee@@ee@@ee@@ee@@e@.w",
        "...................................."
    ],
    "nca_runtime": 4.0772483348846436,
    "milp_runtime": null,
    "nca_milp_runtime": null,
    "sim_score": null,
    "weight": false,
    "n_row": 33,
    "n_col": 36,
    "n_endpoint": 247,
    "n_agent_loc": 0,
    "n_shelf": 265,
    "maxtime": 5000
}