{
    "name": "kiva_xxlarge_cma-es_opt_entropy_throughput_hamming_a=5_n-emitter=5",
    "layout": [
        ".....................................................................................@@ee@@e@@e@e@@e..",
        "w..e@@ee@@ee@@ee@@ee@@ee@@e@@e@@e@e@e.@e@e@e@@e@e@@ee@@e@e@@e@@ee@ee@@e@ee@e@e@@e@@e@e...............w",
        "........................................................................................ee@@e@ee@e@...",
        "..@e.@ee@@ee@@ee@@ee@@e@e@ee@@e@e@@e@e@e@@e@e@e@ee@ee@@ee@e@ee@ee@@e@@e.@e@@e@e@ee@ee@..@.............",
        "w.......................................................................................ee@@ee@e@@e..w",
        "..@e@@ee@@ee@.@e@.@e@..e@e@e@e@e@e@ee@e@e@e@@e@e@e.@e@@ee@e@@e@@ee@ee@@e@e@@e@@e@e@@e@e...............",
        ".........................................................................................e@@ee@@e@e...",
        "w..e@@ee@@ee@@ee@@ee@@ee@@e@e@e@e@e@e@@e@e@e@e@@e@e@e@@ee@@ee@e@ee@@e@@e@@ee@e@@e@e@ee@e.............w",
        "..........................................................................................e@ee@e@e@e..",
        "..@e@@ee@@ee@.@e@.@e@.@ee@@e@e@e@e@e@e@e@@e@e@e@@e@e@e@ee@.@e@..@e@@ee@ee@@e@@e@@e@e@e@@e.............",
        "w..........................................................................................e@e@@ee@..w",
        "..@e@@ee@@ee@@ee@@ee@@ee@@ee@@e@e@e@e@e@e@e@@e@e@e@@e@e@e@@ee@@ee@e@ee@@ee@@e@ee@@e@e@e@@e............",
        "............................................................................................e@e@@ee@..",
        "w.@e@@ee@@ee@@ee@@ee@.@e..@e@e@e@e@e@e@e@e@e@e@@e@e@e@@e@e@ee@@ee@@e@@e@ee@e@e@e@e@e@e@e@@e..........w",
        ".............................................................................................e@e@@e@..",
        "..@e@@ee@@ee@@ee@@ee@@ee@@ee@@e@e@e@e@e@e@e@e@e@ee@e@e@ee@e@e@@ee@.@e@@e@ee@e@e@e@e@e@e@e@@e..........",
        "w.............................................................................................e@e@@e.w",
        "..@e@@ee@@ee@@ee@@ee@.@e@.@e@...@e@e@e@e@e@e@e@e@e@@e@e@e@@e@e@ee@e@@ee@e@e@@e@e@e@e@e@e@e@@e.........",
        "...............................................................................................e@ee@..",
        "w.@e@@ee@@ee@.@ee@@e@@ee@@ee@@ee@e@@e@e@e@e@e@e@e@e@ee@e@ee@e@e@ee@ee@@e@e@e@ee@e@e@e@e@e@e@.@e......w",
        "................................................................................................e@e@..",
        "..@e@@ee@@ee@@ee@@ee@@ee@.@e@@ee@@e@@e@e@e@e@e@e@e@e@e@@e@e@@e@e@e@@ee@@e@e@e@e@@e@e@e@e@e@ee@@e......",
        "w................................................................................................e@e.w",
        "..@e@@ee@@ee@@ee@.@e@@ee@@ee@@ee@@e@e@e@e@e@e@e@e@e@e@e@e@@e@e@e@@e@e@e@@e@e@e@e@ee@e@e@e@e@@e@@e.....",
        "..................................................................................................e@..",
        "w.@e@@ee@@ee@@ee@@ee@e@e@.@e@@ee@.@e@e@e@e@e@e@e@e@e@e@e@e@e@@e@e@ee@e@e@@e@e@e@e@e@@e.e@e@e@@ee@@e..w",
        "......................................................................................................",
        "..@ee@@ee@@ee@@ee@@e.@ee@@ee@@ee@e@@e@e@e.e@e@e@e@e@e@e@e@e@e@ee@e@e..e@e@e@@e@e@e@e@@e@.@e@e@@e@@e...",
        "w....................................................................................................w",
        "..@ee@ee@@ee@@ee@@ee@.@e@e@e@.@e@@e@e@e@@e@e@e@e@e@e@e@e@e@e@e@e@ee@e@e@@e@e@e@@e@e@e@@e@@ee@e.@ee@e..",
        "......................................................................................................",
        "w..e@e@e@e@e@.@ee@@e@@ee@@ee@@ee@.@e@e@e@ee@e@e@e@e@e@e@e@e@e@e@e@e@@e@e@ee@e@e@ee@e@ee@e@ee@@ee@e@..w",
        "......................................................................................................",
        "..@ee@e@e@ee@@ee@@ee@.@ee@@e@@ee@@ee@e@@e@e@@e@e@e@e@e@e@e@e@e@e@e@e@e@@e@e@@e@e@e@@e@e@@e@e@@ee@@e@..",
        "w....................................................................................................w",
        "..@e@e@e@e@e@@ee@.@e@@ee@@ee@@ee@@ee@@e@ee@ee@e@e@e@e@e@e@e@e@e@e@e@e@e@e@@e@e@@e@e@@e@e@ee@ee@ee@@e..",
        "......................................................................................................",
        "w..@e@e@e@e@e@ee@@ee@.@e@@ee@@ee@@ee@@ee@e@@e@@e@e@e@e@e@e@e@e@e@e@e@e@e@e@e@@e@e@@e@@e@e@e@@e@@ee@e.w",
        "......................................................................................................",
        "..@e@e@e@e@e@e.e@@ee@@ee@@ee@@ee@.@ee@@e@@e@@e@@e@e@e@e@e@e@e@e@e@e@e@e@e@e@e@e@@e@@e@@e@e@e@@e@ee@...",
        "w....................................................................................................w",
        "..@ee@e@e@e@e@e@e@@ee@@ee@ee@@ee@@ee@e@@e@ee@e@e@e@e@e@e@e@e@e@e@e@e@e@e@e@e@e@e@@e@@e@@e@e@e@@e@ee@..",
        "......................................................................................................",
        "w.@e@e@e@e@e@e@e@e@ee@@ee@@ee@e.e@@e@@ee@e@e@e@@e@e@e@e@e@e@e@e@e@e@e@e@e@e@e@e@e@@e@@e@@e@e@ee@e@e@.w",
        "......................................................................................................",
        "..@ee@e@e@e@e@e@e@e.e@@ee@@ee@@ee@@ee@@ee@e@e@e@ee@e@e@e@e@e@e@e@e@e@e@e@e@e@e@e@e@@e@@e@@e@e@@e@e@e..",
        "w....................................................................................................w",
        "..@e@e@e@e@e@e@e@e@e@e@ee@@ee@.@e@@ee@@ee@e@@e@e@e@e@@e@e@e@e@e@e@e@e@e@e@e@e@e@e@e@@e@@e@@e@.@ee@e@..",
        "......................................................................................................",
        "w.@ee@e@e@e@e@e@e@e@e@e@ee@@ee@ee@@ee@.@ee@e@ee@e@e@e@ee@e@e@e@e@e@e@e@e@e@e@e@e@e@e@@e@@e@@e@ee@.@e.w",
        "......................................................................................................",
        "..@e@e@e@e@e.e@e@e@e@e@e@e@@ee@@ee@ee@@e@e@ee@e@e@@e@e@e@e@@e@e@e@e@e@e@e@e@e@e@e@e@e@@e@@e@@e@ee@e...",
        "w....................................................................................................w",
        "...@e@e@e@e@e@e@e@e@e@e@e@e@ee@@ee@@ee@e@@e@e@e@@e@e@ee@e@e@e@@e@e@e@e@e@e@e@e@e@e@e@e@@e@@e@@e@e@@e..",
        "......................................................................................................",
        "w.@e@e@e@e@e@e@e@e@e@e@e@e@e@ee@@e@@ee@@e@@e@e@e@e@ee@e@e@e@@e@e@@e@e@e@e@e@e@e@e@e@e@e@@e@@e@@e@e@e.w",
        "......................................................................................................",
        "..@ee@e@e@e@e@e@e@e@e@e@e@e@e@e@.@e@@ee@ee@e@@e@e@e@e@e@@e@e@ee@e@ee@e@e@e@e@e@e@e@e@e@e@@e@@e@@e@e@..",
        "w....................................................................................................w",
        "..@e@e@e.e@e@e@e@e@e@e@e@e@e@e@e@e@e@ee@@ee@e@@e@e@ee@@e@e@@e@e@@e@ee@e@e@e@e@e@e@e@e@e@e@@e@@e@@e@e..",
        "......................................................................................................",
        "w.@ee@e@e@e@e@e@e@e@e@e@e@e@e@e@e@e@e@e@@ee@@e@ee@e@@e@e@@e@e@@e@e@@e@e@@e@e@e@e@e@e@e@e@e@@e@@e@@e@.w",
        "......................................................................................................",
        "..@e@@ee@e@e@e@e@e@e@e@e@e@e@e@e@e@e@e@e@ee@@ee@e@e@e@e@e@ee@e@e@@e@ee@e@e@@e@e@e@e@e@e@e@e@@e@@e@@e..",
        "w....................................................................................................w",
        "..@e@.@ee@e@e@e@e@e@e@e@e@e@e@e@e@e@e@e@e@e@.@e@e@@e@e@e@e@e@e@@e@ee@e@@e@e@ee@e@e@e@e@e@e@e@@e@@e@...",
        "......................................................................................................",
        "w.@e@@ee@.@e@e@e@e@e@e@e@e@e@e@e@e@e@e@e@e@e@ee@@ee@e@e@e@e@e@e@ee@e@@e@e@@e@e@@e@e@e@e@e@e@e@@e@@e@.w",
        "......................................................................................................",
        "..@e@@ee@.@ee@e@e@e@e@e@e@e@e@e@e@e@e@e@e@e@e@e@.@e@e@@e@e@e@e@e@e@@e@e@@e@e@@e@e@@e@e@e@e@e@e@@e@@e..",
        "w....................................................................................................w",
        "..@e@@ee@@ee@@ee@e@e@e@e@e@e@e@e@e@e@e@e@e@e@e@e@ee@@ee@e@e@e@e@e@e@ee@e@e@@e@ee@e@@e@e@e@e@e@e@@ee@..",
        "......................................................................................................",
        "w.@e@@ee@@ee@.@ee@e@e@e@e@e@e@e@e@e@e@e@e@e@e@e@e@e@.@e@e@@e@e@e@e@e@e@@e@e@ee@e@@e@e@.e@e@e@e@e@@e@.w",
        "......................................................................................................",
        "..@e@@ee@@ee@.@e@.@e.e@e@e@e@e@e@e@e@e@e@e@e@e@e@e@e@ee@@ee@e@e@e@e@e@e@e@@e@e@@e@e@.e@ee@e@e@e@e@@e..",
        "w....................................................................................................w",
        "..@e@@ee@@ee@@ee@.@ee@e@e@e@e@e@e@e@e@e@e@e@e@e@e@e@e@e@@ee@@e@e@e@e@e@e@e@@e@e@e@@e@e@@e@@e@e@e@e@...",
        "......................................................................................................",
        "w.@ee@@e@e@e@.@ee@@ee@@e@e@e@e@e@e@e@e@e@e@e@e@e@e@e@e@e@@ee@ee@e@e@e@e@e@ee@e@e@ee@e@e@ee@e@@e@e@e@.w",
        "......................................................................................................",
        "...@e@ee@@ee@@ee@@ee@.@ee@e@e@e@e@e@e@e@e@e@e@e@e@e@e@e@e@@e@@e@e@@e@e@e@e@e@@e@e@e@@e@e@e@@e@e@@e@e..",
        "w....................................................................................................w",
        "..@e@e@ee@@e@@ee@@ee@.@ee@@e@e@e@e@e@e@e@e@e@e@e@e@e@e@e@e@@e@@e@ee@e@e@e@e@e@e@e@@e@e@@e@e@e@@e@e@...",
        "......................................................................................................",
        "w.@ee@e@e@ee@@ee@@ee@@ee@@ee@@e@e@e@e@e@e@e@e@e@e@e@e@e@e@e@@e@ee@e@@e@e@e.e@e@e@e@ee@e@e@@e@e@@e@e@.w",
        "......................................................................................................",
        "..@e@e@e@e@e@.@e@@ee@.@ee@@e@.@e@e@e@e@e@e@e@e@e@e@e@e@e@e@e@@e@e@@e@ee@e@e@@e@@e@e@ee@e@e@e@@e@ee@e..",
        "w....................................................................................................w",
        "...@e@e@e@e@e@ee@.@e.@ee@@ee@@ee@@e@e@e@e@e@e@e@e@e@e@e@e@e@e@@e@e@@e@@e@e@e@ee@e@@e@e@@e@e@e@ee@e@...",
        "......................................................................................................",
        "w.@e.e@e@e@e@e@e@@ee@@ee@@ee@@ee@@e@@e@e@e@e@e@e@e@e@e@e@e@e@e@@e@e@e@@ee@e@e@e@@e@@e@e@ee@e@e@e@@e@.w",
        "......................................................................................................",
        "...@e@e@e@e@e@e@e@.e@@ee@@ee@@ee@@ee@ee@e@e@e@e@e@e@e@e@e@e@e@e@e@@e@e@@e@e@@e@e@ee@e@@e@e@@e@e@e@e...",
        "w....................................................................................................w",
        "..@e@e@e@e@e@e@e@@ee@.@e@@ee@.@ee@@e@ee@@e@e@e@e@e@e@e@e@e@e@e@e@e@e@@e@e@@e@e@@e@e@@e@ee@e@ee@e@e@e..",
        "......................................................................................................",
        "w..@e@e@@e@@e@e@e@ee@@ee@@ee@@ee@@ee@@e@@ee@@e@@e@@e@e@@e@@e@@e@@e@@e@@e@e@@e@e@@e@e@e@@e@e@@e@ee@e@.w",
        "......................................................................................................",
        "..@e....e@.e@.@ee@@e@@ee@@ee@@e@e@@e@e@@e@@e@@e@@e@@e@@e@e@@e@@e@@e@@e@e@@e@e@@e@@e@.@e@e@@e@e@@e@@e..",
        "......................................................................................................"
    ],
    "nca_runtime": 0.4270615577697754,
    "milp_runtime": 119.60699391365051,
    "nca_milp_runtime": 120.03405547142029,
    "sim_score": null,
    "weight": false,
    "n_row": 101,
    "n_col": 102,
    "n_endpoint": 2285,
    "n_agent_loc": 0,
    "n_shelf": 2500,
    "maxtime": 5000
}