{
    "name": "kiva_large_200_agents_cma-es_opt_entropy_throughput_hamming_a=5_n-emitter=5",
    "layout": [
        "....................................",
        "w.e@ee@@ee@@e@@ee@@ee@@e@@e@e@@e@..w",
        "....................................",
        "...@ee@.@e@@ee@ee@@ee@.@e@e@@e@ee@..",
        "w..................................w",
        "...e@e@@ee@@ee@@ee@@e.@ee@@ee@e@e@..",
        "....................................",
        "w.e@ee@@ee@.@e@@ee@ee@.@e@@ee@@e@e.w",
        "....................................",
        "..e@ee@@ee@@ee@e@e@@e@@ee@@ee@@ee@..",
        "w..................................w",
        "..@e@e@@ee@.@e@@e@e@ee@@ee@@e@@ee@..",
        "....................................",
        "w...e@e@ee@@ee@@ee@e@e@@ee@ee@e@e@.w",
        "....................................",
        "..e@e@@e@e@@ee@@ee@@e@e@ee@@e@@ee@..",
        "w..................................w",
        "...e@ee@e@e@ee@@ee@@ee@e@ee@@e@ee@..",
        "....................................",
        "w...e@ee@.@e@e@@ee@.@e@@e@e@ee@@e@.w",
        "....................................",
        "..@e.e@e.@e@e@e@ee@@ee@@ee@e@ee@@e..",
        "w..................................w",
        "...@e.e@e.e@e@ee@ee@@e@@ee@@e@e@e...",
        "....................................",
        "w.e@ee@e.e@e@e@e@@e@ee@e@e@e@e@e@e.w",
        "....................................",
        ".....e@e.e@@ee@@e@e@@e@@ee@@ee@@e@..",
        "w..................................w",
        "...e@ee@ee@@ee@e@e@e@e@@ee@.@ee@@e..",
        "....................................",
        "w...@ee@.e@e@e@@ee@e@@e@@e@@ee@@e..w",
        "...................................."
    ],
    "nca_runtime": null,
    "milp_runtime": null,
    "nca_milp_runtime": null,
    "sim_score": null,
    "weight": false,
    "n_row": 33,
    "n_col": 36,
    "n_endpoint": 239,
    "n_agent_loc": 0,
    "n_shelf": 240,
    "maxtime": 5000
}