{
    "name": "kiva_xxlarge_cma-es_opt_entropy_uneven_throughput_hamming_a=5",
    "layout": [
        ".....@@@@@@e@@@@@@@@@e@@@@@@@@@@@e@@@@@@@@@@@e@@@@@@@@@.@e@@@@@@@@@e@@e@@@@@@@@@@e@@@@@@@@@@@e@@@@@@..",
        "w..e@eeeee.e@eeeeeee...eeeeeeeee...eeeeeeeee...eeeeeeee...eeeeeeee......eeeeeeee...eeeeeeeee@..eeeee.w",
        "...e.@@@.@.@.@@@@@@@.e.@@@@@@.eee@@@@@@@@@.ee@@@@@@@@.eee@@@@@@@@.@ee@@@@@@@@@e@e@@@@@@@@@.@@e@@@@@@..",
        "...@...e.e.e.@.....e.@.e....ee@@.eee@....e@@.eee....e@@@@e.e...@e.@@@@ee.....e@@@eee@@..@ee@@eee.@....",
        "w..e.e@e.e@e.e@@.@.@.e.e@e.@@..e.@.eeee@@..e@@@eee@@...e@@.eee@@..ee@@.eee@@...e.@@.eee@@@..e@@@@ee..w",
        "...e.e@e@e.@.e.e.e.e.e.@@@.eee.@.e.@@@.eee.@.eee@@@eee@@.e.@@@@ee@@..e.@@@@ee@.@.e..@@@@ee.@@@ee@@@...",
        "...@.@.e.e.e.@.e.e.e.@.@ee.@.@.e.e@..e.@@@ee.@...e@@@eee.@...e@@.eee@@...e@@.e@e.@...e@@@@@ee@@..ee@..",
        "w..@.e.@.@.e.e.@.@.@.e.e@e...e.@.eee.@.eee@@.ee@@@.e.@.@.ee@@..e.@@@ee.@.@.e.@@@.e@e@@.e@e@@.e@e@.e..w",
        "...e.e.e.e.@.@.e.e.e.e@e.e.@.@.e.@.@.e.@@..e@@.eee.@.e.e@@.eee.@.ee@@@.e.e.@.eee@@@eee.@@e.e.@.e@e@...",
        "...e.@.e.e.e.e.e.e@e.e.e.@.e.e.e.e.@@@.ee@@@.e.@.@.e.@...e.@@@ee.@...e.@.@.e@@.@.e@@@@@e.e@@.e.@@@@e..",
        "w..@.e.@.@@e.@.@.e.e@@.@.e.@.@.@.@.eee.@.eee@@.e.e...e.e.@.@.@@@.e.e.@.@.e.e.e.e.@...e@@.eee@@.ee.@@.w",
        "...e.e@e.e.e.@.e.@.e@@.@.e.@.e.e.e.e.@.e.@@@.e.e.e.e.@.@...e.e.e.@.@.e.e.e.@.@.@.e.e.@@e.@@@@e.@..e...",
        "...@.e@@.e@@.e.@.@.e.e.e.@.e.e.e.@.@.e.@...e.e.@.@.@...e.e.e.e.@...e.e.@.@...e.e@@.@.e.@.e@@.@@e.@@...",
        "w..e@e.e.e.e.e.@.e.@.@.@.e.e.@.@.e...e.e.e.@.@.@...e.e.@.@.@.@.e.e.@.@...e.e.@.@.@@e.@@e.@@e.e@@.e@..w",
        "...e@e.e.@.e.@.e@e.@.e.@@e@@.e.e.e.e.@.@.@.e.e.e.e.@.@...e.e.e.@.@...e.e.@.@.@@e.e.@.e@@.@@e@e@e.@@...",
        "...e.e.@.e.@.e.e.e.e.e.e.@.e.e.e.@.@.e...e.e.e.@.@...e.e.@.@.@...e.e.@.@.e.e.e.@.@.e.@@e.e@@@e@@.@e...",
        "w..@.@.e.e.e.e.@.@@e.@.e.@.@.@.@...e.e.e.@.@.@...e.e.@.@@e.e.e.e.@.@.e.e.e.@.@.e.@.e.e@@.@.@@e.e.@@..w",
        "...e.e.e@@.e.@.e.e.e.e.@.e.e.e.e.e.@.@.@.e...e.e.@.@...e.e.e.@.@...e.e.@.@.e.e.e.e@@.@@e.e.e@@.@.ee...",
        "...e.e@e.e.@.e.e.@.@.e.e.@.e@e.@.@.@...e.e.e.@.@.e.e.e.@.@.@.e.e.e.@.@.e.e.e@@.@.@.@.e.@@e.@.@.e.@@...",
        "w..@.e@e.@.e.e.@.e.e.@.e.e.e.e.e.e.e.e.@.@.@.e.e.e.@.@.e.e@e.e.@.@...e.e.e.@.@...e.e.@.@.@...e@e@@ee.w",
        "...e.e@e.e.e.@.e.e.@.e.@.@.@.@.e.@.@.@.@...e.e.@.@...e.e.@.@.@...e.e.@.@.@...e.e.@.@.@@e.e.e@@.@.@@@..",
        "...e.e.e.@.@.@.@.@.e.e.e.e.@.e.@.e.e.e.e.e.@.@.@.e.@.@.@...e.e.e.@.@.e.e.e.e.@.@.@@e.e@@.@.@.@.e.e@e..",
        "w..@.@.@.e.e.e.@.e.@.@.@.e.e.e.e.@@e.@.@.@.@...e.e.e.e.e.e@@.@.@...e.e.@.@.@...e.e.@.@.@.@@e.e.@@e...w",
        "...e.e.e.e.e.e.e.@.@.e.@.@.e@@.e.e.e.e.e.e.e.e.@.@.e.@.@.@...e.e.e.@.@.@...e.e.@.@.@...e.e@@.@.@.e....",
        "...e.e.@.@.@.@.e@e.e.@.e.@@e.e.@.e@@@e.e@@.@.@.@.@.@.e.e.e.e.e.@.@...e.e.e.@.@.e.e.e.e@@.@.@.@.e@@@...",
        "w..@.@.e.e.e.e.e.e.e.@.e.e.@.e.@.e@e.e@e.e.e.e.e.e.e.e.e.@.@.@.e.e.e.@.@.@...e.e.@.@.@...e.e.e.@.@e..w",
        "...e.e.e@e@e.e.@.@.@.e.@.e.e.@.e.e.e@e@e.e@e.@.@.@.@.@.@...e.e.@.@.@.e.e.e.e.@.@.@...e.e.@.@.@.@.e....",
        "...e@e.e.e.e.@.e.e.e.e.e.@.e.e.@.@.e.e.e@e.e.e.e.e.e.e.e.e.@.@.e.e.e.e.@.@.@.e.e.e.e.@.@.@...e.e@@e...",
        "w..e.@.@.@.@.e.@.e.e.@.e@e.@.e.e.e.@.@.e@e.@.e.e@e.e.@.@.@...e.e.@.@.@.@...e.e.@.@.@.e.e.e.e.@.@.e@..w",
        "...@.e.e.e.e.e.e.@.@.e.e.e.e.@.e.e.e.e.e@e.e.@.e.@.@.@...e.e.@.@.e...e.e.e.@.@.@...e.e.@.@.@.@.e.ee...",
        "...e.e@e.@.@.@.@.e.e.e.@.@.e.e.@.@@e.e@e@e.e.e.@...e.e.e.@.@...e.e.e.@.@.@...e.e.e.@.@.@...e.e.e@@@...",
        "w..e@e.e.@.e.e.@.e@e.@.e.e.@.@.e.e@e.e.e@e.@.e.e.e.@.@.@.@.e.e.@.@.@...e.e.e.@.@.@.e.e.e.e.@.@.@.@e..w",
        "...e.e@@.e.e@e.e.e.e.e.e.e.e.e.e.e@e.@.e@e.e.@.@.@.@.e.e.e.@.@...e.e.e.@.@.@.@...e.e.e.@.@.@...e.@@...",
        "...@.@.e.e@e.e@e.@.@.e.@.@.e@e.@.@@e@e.@.e.e.e.e.e.e.e.e.@.e.e.e.@.@.@.@...e.e.e.@.@.@.e.e.e.e.@.ee...",
        "w..@.@.@.e.e.e.e.e.e.@.e.e.e.e.e.@.e@e.@.@.@.@.@.@.@.@.@.e.e.@.@.e...e.e.e.@.@.@.e...e.e.e.@.@.e..@..w",
        "...e.e.@.@.@.@.@.e@e.e.e.e.@.@.e.e.e@@.e.e.e.e.e.e.e.e.e.e.@.e.e.e.e.@.@.@.e...e.e.e.@.@.@.@.e.e@ee...",
        "...e.@.e.e.e.e.e.e.e.e.@.@.e.e.@.e.e@e.e@e.e.e.e.e.@.@.@.@.e.e.@.@.@.e.e.e.e.e.@.@.@.e.e.e.e.e.@......",
        "w..@.e.e.e.e.e@@.@.@.@.e.e.e@e.e.@.e@e.@.e.@.@.@.@.e.e.e.e.@.@.e.e.e.e.e.@.@.@.e...e.e.e.@.@.@.@.@e..w",
        "...e.e.@.@.@.e.e.e.e.e.e@e.e.@.e.e.e@e.e.@.e.e.e.e.@.e.@.@.e.e.e.@.@.@.@.e.e.e.e.e.@.@.@.@.e.e.e@.....",
        "...@.@.e.e.e.@@e.e.e.e.e.e@@.e.@.e.e.e.e.e.e.e.e.e.e.@.e.e.e.@.@.e.e.e.e.e.e.@.@.@.@...e.e.e.@...e@@..",
        "w..@.e@e.e.@.e.e@@.@.@.@.e.e.e.e.@.@.@.@.@.@.@.@.@.e.e.e.@.@.e@e.e.e.@.@.@.@.e.e.e.e.e.@.e.@.ee.@.ee.w",
        "...e.e@e.@.e.e.e.e.e.e.e.@.e.@.e.e.e.e.e.@.e.e.e.e.@.e.@.e.e.e.e.@.@.e...e.e.e.e.@.@.@.e.@.e.@@.e.@...",
        "...e@@.e.e.e.@.@.e.e.e.e@e.@.e.@.e.e.e.e.e.e.e.e@e.e.@.e.@.@.@.@...e.e.e.@.@.@.@.e...e.e.e.@.ee@@.e...",
        "w..e@e.@.e.@.e.e.@.@.@.e@e.e.e.e.@.@.@.@.@.@.@.e.e.e.e.e.@.e.e.e.e.@.@.@.@...e.e.e.e.@.@.@.e@...e.@..w",
        "...@.e.e.@.e.e.e.e.e.e.e@e.@.@.@.e.e.e.e.e.e.e.@.@.@.e.@.e.e@e.@.@.e...e.e.e.@.@.@.@.e.e.e...@e.@.e...",
        "...e.@.e.e.e.@.@.e@e.e.e@e.e.e.e.e@e.e.e.e.@.e.e.e.e.@.e.e.e@e.e.e.e.e.@.@.@.@.e.e.e.e.@.ee.@.e.e.@...",
        "w..e.e.@@e.@.e.e.e.e.@.e.e@e.e.e.e.@.@.@.@.e.@.e@e.e.e.e.@.e.e@e.@.@.@.@...e.e.e.e.@.@.e.@@.e.@.@.@..w",
        "...@.e@e.e.e.e.e.@.@.e.@@e.e@@.@.@.@.@.e.e.e.e.e.e.@.e.@.@.@.e@e.e.e.e.e.e.@.@.@.@.e.e.@.ee@@.e.e.e...",
        "...e.e.@.@.@.@.@.@.@.e.e.e@e.e.e.e.e.e.e.e.@.e.@.@.e.@.e.e.e.e.e@e.e.@.@.@.@...e.e.e.@.e.@@.e.e.e.e...",
        "w..e.@.e.e.e.e.@.e.e.@.@@e.e@e.e@e.e.e.@.@.e.@.e.e.e.e.e.e.e.@.e.e.@.e.e.e.e.e.@.@.@.e...e@.@.@.@.@..w",
        "...@.e.e.e.e.e.e.e.e.e.e.e@e.@.e.e.@.@.e.e.e.e@e.e.@.e.@.@.@.e.@.@.e.e@e.@.@.@.@...e.e.e@.@@e...e.e...",
        "...e.e.@.@.@.@.@.@.@.e.e@e.e.e.@.@.e.e.e.e.@.e.e.@.e.@.e.e.e.e.@.@.e.e@e.e.e.e.e.e.@.@@.e.e.@.e.@.@...",
        "w..e.@.e.e.e.e.e.e.e.@.e@e.@@e.e.e.@.e@@.@.e.@.@.e@e.e.e@e.e.@.e.e.@.e@e.e.e.@.@.@.e..e.@.@.e.@...e..w",
        "...@.e.e.e.e@e.e.@@e.e.e@e.e.e@e.e.e@e.e.e.e.e.e.e.e.e.e.e.@.e.e.e.e.e@e@@.@.e.e.e.ee@@@e.e...e.e.@...",
        "...e.e.@.@.e@e.@.e.e.e@e.e.e@@.@.@.e@e.e.e.@.e@e.@.@.@.@.@.e.e.@.@.e.e.e@e.e.e.@.e.@@@e.@.e.e.@.@.@...",
        "w..e@@.e.e.e@e.e.e.@.e@e.@.@.e.e.e.e@e.@.@.e.e@@.@.e.e.e.e.@.@.e.e.@.@.e.@.@.@.e.@.ee@@.e.@.@...e.e..w",
        "...e@e.@.@.e.e.e.@.e.e@e.e.@.@.e.e.e@e.e.e.e@e.e.e.e@e.e.e.e.e.e.@.e.e.@.e.@.e.e@e.@@@e.@.e.e.e.@.@...",
        "...e.e.e.e.@.@.@.e.e.e@e.e.e.e.@.@.e.e.e.e.e.e.e@e.e.e.@.@.e@e.@.e.@.@.@.e@e.e.e.@.ee@@.e.@.@.@...e...",
        "w..@.@.e@e.e.e.e.@.@.e.e.@.e@e.e.e.@.@.@.@.@.@.e.e.@.@.e.e@e.e@e.@.@.e.e.e.e.@.@.e@@..e@@.e...e.e.e..w",
        "...e.e.e.e@e.e@e.e.e.@.@.e.e.e@e.@.e.e.e.@.@.e.@.@.e.e.e.e@e.e.@.e.e.e.@.@.@.e.e...ee@..e.e.e.@.@.@...",
        "...e@@.@.e.@.e@e.e@e.e.e.e.@.e.e.e.e@e.e.e.e.e@e.e.e@e.@.e.e.@.e.e.@.@.e.e.e.e@e.e@.e.e@@.@.@...e.e...",
        "w..e@@.@.@.e.@.e.e@e.e.e.@.e.@.@.e@e.e.@.e@e.e.e.e.e@e.e.@.@.e@e.@.e.e.e@e.@.e.@@.ee@.@.e...e.e.@.@..w",
        "..@e.e.e.e@e.e.@.e@e.@.@.e.e.e.e.e.@.@.e.e@e.@.@.@.e.e.e.e.e.e@e.@.e.@.@.@.e.@.ee.@.e.e.@.e.@.@.e.e...",
        "...e@e.e@e.e.e@e.e@e.e.e.e.@.e@@.@.e.e.e.e.e.e.e.@.@.@.@.e.e.e@e.e.@.e.e.e.e@ee@@.e.@.e.e.@...e.e.e...",
        "w..e.e@e.e.@.e@e.e.@.e.e.@.e.e.e.e.e@e.@.@.@.e.e.e.e.e.@.@.@.@.e.e@e.e@e.@.e.@@@e.@.e.@...e.e.@.@.@..w",
        "...@.@.e@@.e.e.@.@.@.@.@.e.@.@.e@e.e.@.e.e.e.@.@.e.e.@.e.e.e.e.@.e.e@e.e.e.@.ee@@.e.@.e.e.@.@.e.e.e...",
        "...e.e@e@e@@.@.e.e.e.e.e.e.e.@.@.e.@.e.e@e.e.e.e.@.@.e.e.e.e.e.e.@@e@e.@.e.e..@.e.@.e.@.@.e.e.e.e.@...",
        "w..@.e.@.e.e.e.e.e.e@e.e.@.e.e.e.@.e.e.e@e.@.@.@.e.e.e.@.@.@.@.e.e@e@@.e.@.@.ee@@.e.@.e.e.e.@.@.@.e..w",
        "...e@@@e.@@e.e@@.@.e.@.@.e.@.e@e.e.e.@.e.e.e.e.e.e.e.@.e.e.e.e.@.@.e@e.e.@.ee@@.e.@.e.@.e.@.@...e.e...",
        "...e.e.@@e@e@e.@.e.@.e.e.@.e.e.e.e.@.e.@.@.e.e@e.@.@.e.e.e.e.e.e.e.e.e.@.e...ee.@.e.@.e.@...e.e.@.@...",
        "w..@.e@@.e@@.e.e.e.e.e.e.e.@.@.@.@.e.@.e.e@@.e.e.e.e.e.@.@.@.@.e.e.@.@.e.@.e@@@.e.@.e.@.e.e.@.@.@.e@.w",
        "...e.e@e.@@e@@@e.@.e.@.@.e.e.e.e.e.e.e.e.e.e.@.@.e@e.@.e.e.e.e.@.@.e.e.e@e@..ee@@.e.@.e.@.@.@.e.e.e...",
        "...e@e.e.e.e.@.e.e.@.e.e.@.e.e.e@e.@.e.@.@.e.e.@.e@e.@.e@e.e.e.e.e.e.e@e...e@...e.@.e.@.@...e.e.@.@...",
        "w..@@e@@@e@@.e.@.e.e.e@e.e@@.@.e@e.e.@.e.e.@.e@e.e@e.e.e.@.@.@.e.e.@.@.e.e@.@ee@..e.@.e.e.e.@.@.e.e..w",
        "...e.e@e@e.e.e@@.@.e@e.e.e.e.e.e@e.e.e.e.e.e.e.e.e.e@e.@.e.e.e.@.@.e.e.@..ee@.e.e.@@e@e.@.@.e.e.e.e...",
        "...e@@.e.e.e@e.e.e.e@e.@.@.@.e.e.e.@.e.@.@.e.@.@.@@e.e.@.e.e@e.e.e.e.@.e..@.e.@.@.e.e.@.e.e.e.e.@.@...",
        "w.@e.e@@.@@e@e.e@e.e@e.e.e.e.@.@.@.e.@.e.e.@.e@e.e@e.@@e.@.e.e@@.@.@.e.e@.e.@.e.e.@.@.e.e.@.@.@...e..w",
        "...e@e.e.e.e@@.e.e@e.e@e.@.e.e.e.e.@.e.e.e.e.e.e.e@e.e.e.e.@.e@e.e.e@e.ee.@.e.@...e.e.e.@.e.e.e.e.@...",
        "...e@e@e.@.e@e.@.e.e@e.@.e.@.@.e@e.e.e.@.@.e.@.@.e@e.e.@.e.e.e.e.e.@.e.@@.e.@.e.e@e.e.@.e.e.@.@.@.@...",
        "w..@@e@@.e@@@e.e.@.e@e.e.e.e.e.e.e.e.@.e.e.@.e.e.e@e.@.e.@@e.@.@.@.e.@.ee@@.e.@...@.@.e.@.@.e.e.e.e..w",
        "...e@@@e@e@@.e.e.e.e@e.@.@.e.e.@.@.@.e.e@e.e.e@e.e.e.e@e.e@e.e.e.e.@.e.@@.e.@.e.@.e.e.e.e.e.e@e.@.@...",
        "...e@@@e.e.e.@.@.e@e.@.e.e.@.@.e@e.e.e@e.e.e.e.e.@.@.e.e@e.e.e.e.e.e@@.ee@@.e.e.e.e.e.@.e@e.e@e.e.e...",
        "w..@@e.e@@.e.e.e.@@e.e.e.e.e.@.e@e.e.e.e.@.@.@.@.e.@.@.e@e.@.@.@.@.@.ee@@.e.@.@.e.@.@.e.e@e.e@e.e.e..w",
        "...e@@.@@e.@.e.e.e.e.@.@.@.e.e.@.@.@.@.@.e.e.e.e@e.e.e.e@e.e.e.e.e.e@..ee@@.e.e.@.e.e.e.e.e.e@e.@.@...",
        "...e@@.e@@.@.@.@.@.@.e.e.e.@.@.e.e.e.e.e.e@e@e.e.e.e.@.@.e.@.e.@.e@.@ee@@.e.@.@.e.e.e.@.@.@.e.e.@.e...",
        "w..e@e.e.e.e.e.e.e.e.@.e.e.e.e.e.e@e.e.e.e.e@e.@.@.@.e.e.@.e@@@e.e.e@.e.e@@.e.e.e.@.@.e.e.e.@.@.e@e@.w",
        "...e@@.@.e@@.e.e@e.e.e.@.@.e.e.@.e@e.@.@.@.e@e.e.e.e.e.e.@.@.e.e.@@.ee@...e.@.e.@.e.e.e.@.e.e.e.e@e...",
        "...e@e@@.@.e.@.@.e.@.e.e.e.@.@.e.@.@.e.e.e.e.e.@@e.e.@.@.e.e.@.@.eee@.e.e@@.e.@.e.e.e.@.e.@.e@e.e@e...",
        "w.@e@e.e.e.@.@.@.@.e.@.e@e.e.e.e.e.e.e.e@e.@.@.e@e.@.e.e.e@e.e.e@@@.e.@...e.e.e.e.@.@.e.e@e.e.e.e@e..w",
        "...@@e.e.e@e.e.e.e.e.e.e@e.e@e.@.e.e.@.@.@.e@@@e@e.e.e.e.e@e.e.@@.ee@.e.e.@.@.e.@.e.e.e.e.e.@.@.e@@...",
        "...@.e@@.e@e.e.e@e.@.e.e.e.e.e.e.@.@.e.e.e.@.e@e.e@e.@.@@e.@.@.ee.@.e.@.@.e.e.@.e.e.e.@.@.@.e.e.e.e...",
        "w..e@@.@.@@e.@.e.e.e.@.@.@.@.@@e.e.e.@.e.e.@.e.e@e@e.e.e.e.e.e.@@.e.@.e.e.@.e.e@e.@.@.e@e.@.e@e.@@e..w",
        "...@.e.e.e@e.e.@.@.@@e.e.e.e.e.e.e@e.e.@.@.e.@@e@e.@.e.e.@.e.@.ee.@.e.@.@.@.@.@.@.e.e.e.e.e@e.e.e.e...",
        "..@e@e.e.@@e.@.e.@.e.e.e.e.e.e.@.e@e@e.e.e@e.e@e.e.e.@.@@e.@.ee@@.e.@.e.e.e@e.e.e.e.e.@.@.e@@.@@e.@...",
        "w..e.@.@.e@@.e@e.e.@.@.@.@.@.@@e@@.e.e.e.e@@.e@@.@.e.e.e.@.e.@@@e.@.e.@.@.e.e.e.e.@.@.e.e.@@e.e@@.e..w",
        "...@@e.e.@@e.e.e@@.e.e.e.e.e.e.e@e.@.@.@.@.e@e.e@e.@.e.e.e.@.ee@@.e.@...e.@.@.@.@.e.e.e.e.@@e.e.e@e...",
        "...e.e@@.e@e.@.e@@@e.@.e.e@e.@.e.e.e.e.@.e.e.e@@.e@e.@.@.@.e@.@.e.@.e.e@e.e.e.e.e.e.e.@.@.e.e.@.e.e...",
        "w.@e.@@e@@@e.e.@.e.e.e@@.e@e.e.@.@.e@e.e@e@@@e.e.e.e.e.e.e...ee.@.e.e.e@e.e.e.e.e.@.@.e.e.e.@.e.@.@..w",
        "...@@e@e@@.e@e@@@e@@.e@e@e@e@e.e.e.e@e.@@e@@.@.@.@.@.e@e.@..@@@.e.@.@.e@e.@.@.@.@.e.e.e@e.@.e@e.e.e...",
        "...e.e.e.e.e.e.e.e.e.e.e.e.e.e.e.e.e.e.e.e.e.e.e.e.e.e.e.ee.eee.e.e.e.e.e.e.e.e.e.e.e.e.e.e.e.e.e.e...",
        "...@.@.@.@.@.@.@.@.@.@.@.@.@.@.@.@.@.@.@.@.@.@.@.@.@.@.@.@@.@@@.@.@.@.@.@.@.@.@.@.@.@.@.@.@.@.@.@.@..."
    ],
    "nca_runtime": 0.20992445945739746,
    "milp_runtime": 436.12159276008606,
    "nca_milp_runtime": 436.33151721954346,
    "weight": false,
    "n_row": 101,
    "n_col": 102,
    "n_endpoint": 3057,
    "n_agent_loc": 0,
    "n_shelf": 2500,
    "maxtime": 5000
}