{
    "name": "kiva_xxlarge_cma-es_opt_entropy_uneven_throughput_hamming_a=5_n-emitter=5",
    "layout": [
        "......................................................................................................",
        "w.@e.e@e@e@e@e@e.e@e@e.e@e.e@e..@ee@@e@.@e@@e@e@e@e@@e@@e@@e@@ee@@e@@e@@e@@e@@e@@e@@e@.@e@@e@@e@@e@..w",
        "......................................................................................................",
        "..@e@e.e@e@e.e@e@e.e@e@e@e@e@e.@ee@.@e@e.e@e......@e@@ee@@ee@...e@@e@e@@e@@e@@e@e@@e@@e@@e@@e@@e@@e@..",
        "w....................................................................................................w",
        "..@e@e@e.e@e.e@e.e@e@e@e.e@e@e..@ee@@e.e@.e@@e@e.e@@e@@e@@e@e@@e@@e@@e@@e@@e@@e@@e@@e@@e@@e@@e@@e@@e..",
        "......................................................................................................",
        "w.@e.e@e@e@e@e.e@e@e@e.e@e.e@e@e@@e@@e@@e..@e@@e@@e@@ee@@e@@e@@e@@e@@e@.e@@e@@e@@e@@e@@e@@e@e@@e@@e@.w",
        "......................................................................................................",
        "..@e@e.e@e@e.e@e@e.e@e@e.e@e.e@@e@e....e@..@ee@@e@.@e@@e@@e@@e@@e@@ee@@e..@e@e@@ee@@e@@e@@e@@ee@.@e@..",
        "w....................................................................................................w",
        "...e@e@e.e@e@e@e.e@e@e@e@e@e@e.@e@@e@e@@e@@e@@e@@e@@e@@e@@e@@e@..@ee@@e@e@@e@@e@@e@@e@e@@e@@e@@e@@e@..",
        "......................................................................................................",
        "w.@e.e@e@e@e@e@e.e@e@e.e@e@e@ee@e@@e@@ee@@e@.@e@@e@@e@@e@@e@@e@@e@.@e@e@@e@@e@@e@@e@e@@e@@e@@e@@e@@e.w",
        "......................................................................................................",
        "..@e.e@e.e@e@e@e@e@e.e@e@e@e.e@e@@e@@e@@e@@e@@e@@e@@e@@ee@.@e@@e@@e@@e@@e@e@@e@@e@@e@@e@.@e@@e@@e@@e..",
        "w....................................................................................................w",
        "...e@e@e.e@e@e@e@e@e@e.e@e@e.e@@ee@@ee@..e@@e.e@@ee@@e@e@@e@@e@@e@@e@@e@@e@@e@@e@@e@@e@e@@e@@e.@e@e@..",
        "......................................................................................................",
        "w.@e@e.e@e.e@e@e@e.e@e@e@e@e....@e@.@e@@e@@e@@e@e@e@@e@@e@@e@@e@@e@@e@@e@@e@@e@@e@@e@@e@@e@@e@@e@@e@.w",
        "......................................................................................................",
        "..e@.e@e.e@e@e@e.e@e.e@e@e@e@@e@..e@@e@@e@@e@@ee@@ee@@e@@e@@e@e@@e@@e@@e@@e@@e@@ee@e@.@e@@e@.@e@.@e@..",
        "w....................................................................................................w",
        "...e@e.e@e.e@e.e@e.e@e@e@e@e@.e@@e@@e@.@e@@e@e@@e@@e@@e@@e@@e@@ee@@e@@e@@e@@e@.@e@@e@@e@@e@@ee@@e@@e..",
        "......................................................................................................",
        "w..e@e@e.e@e@e.e@e@e@e.e@ee@.@e.@e@@ee@@e@.@e@.e@@e@@e@e@@e@e@@e@@e@e@.@e@@e@@e@@e@@e@@e@@e@@e@@e@e@.w",
        "......................................................................................................",
        "...e@e@e@e.e@e.e@e@e.e@e.e@.@e@e....@e@@e@@e@@e@@e@@e@@e@@e@e@.@e@ee@@e@.@e@@e@@e@@e@@e@@e@@e@@e@@e...",
        "w....................................................................................................w",
        "...e@e.e@e.e@e@e.e@e@e.e@e....@e@@ee@@e@@e@@e@@e@@ee@@ee@@e@.@e@@ee@@e@@e@@e@@e.e@@e@@e@@e@@e@e@@e@...",
        "......................................................................................................",
        "w.@e@e.e@e.e@e@e.e@e@e.e@ee@.@e@e@@e@@e@@e@@e@@e@@e@@e@@e@@e@@e@.e@@e@e@@e@ee@@e@@ee@@e@@e@@e@@e@@e@.w",
        "......................................................................................................",
        "..@e@e@e@e@e@e.e@e.e@e@e@@e@e.@ee@@e@@e@@e@@e@@e@e@@e@@e@@ee@@e@@e@@e@@e@@e@@e@@e@@e@@e@@e@@e@@e@@e@..",
        "w....................................................................................................w",
        "...e@e.e@e@e.e@e@e.e@e.e@@e@@e@e@e@@e@@e@e@e@...e@@e@@e@.@e@e@@ee@@e@@e@@e@@ee@@e@@e@@e@@e@@e@@e@@e@..",
        "......................................................................................................",
        "w.@e@e.e@e@e@e@e@e@e@e@@e@e@@e@e@@e@@e@@e@@e@@e@@e@@e@@e@@e@@e@e@@e@@e@@e@@e@@e@@e@@e@@e@e@@ee@@e@@e.w",
        "......................................................................................................",
        "..e@@e.e@e@e@e.e@e@e.e@@e@@e@@e@@e@@e@@e@@e@@e@@e@@e@@e@@e@@e@@e@@e@@e@@e@@e@@e@@e@@e@@e@@e@e@@e@e@...",
        "w....................................................................................................w",
        "..e@@e@e.e@e@e.e@e@e.e@e@@e@e@@ee@@ee@e@@e@@e@@e@e@@e@e@e@@e@e@@e@.@e@.@e@@e@@e@@e@@e@@e@@e@.@e@@e@...",
        "......................................................................................................",
        "w.e@@e@e.e@e.e@e@e.e@.e@...@e@...@e@.@ee@@e@e@@e@@e@@e@@e@@e@e@@e@@e@@e@@e@e@@e@e@@e@@e@e@e@...@e@e@.w",
        "......................................................................................................",
        "..e@@e@e@e.e@e.e@e.e@e@@e@.@e@@ee@e@@e@@e@@e@@e@@e@@e@@e@@e@@e@@e@@e@@e@e@@e@@e@@e@@e@e@@e@.e@@e@@e@..",
        "w....................................................................................................w",
        "..e@ee@e@e@e.e@e@e@e@e@..e@..@@e...ee@e@@e@@e@@e@@e@@e@e@@e@.@e@@e@@e@@e@@e@@e@@e@@e@@e@@e@@e@@e@.e@..",
        ".............................eee@e@@..................................................................",
        "w.e@@e@e@e.e@e.e@e.e@e@e.e@.@e..........e@eee@@ee@@e.e@@e@@e@@e@e@@e@@e@@e@@e@@e@@e@@e@@e@@e@@e@@e@..w",
        ".............................e@e@.e@e@e@e@e@e.........................................................",
        "..e@ee@e.e@e@e@e.e@e.e@e.e@.@e...............e.e...@e@e@@e@@ee@@e@@e@@e@@e@e@@e...e@@ee@@e@@e@@e@@e@..",
        "w.............................e@e.e@e@e@e@e@e@e@e....................................................w",
        "..e@ee@e.e@e.e@e@e.e@e.e@ee@@e......................e.e@@e@e@@e@@e@@e@@ee@@e@e@@e@ee@@e@@ee@@e@@e@@e..",
        "..............................e@e@e.e@e@e.e@e@e@e@e@@e................................................",
        "w.e@ee@e@e.e@e@e.e@e@e@e.e@.@e..........................ee.e@@e@@ee@e@e@@e@@e@@e@@ee@@e@@e@..@e@@e@..w",
        "..............................e@e.e@e@e.e@e@e@e@e@e@@e@e@@e...........................................",
        "..e@ee@e@e@e@e.e@e@e.e@e.e@@e@..............................e.e@@e@@e@@e@@e@@e@.@e@@e@@e@e@@e@@e@@e@..",
        "w.............................e@e.e@e@e@e@e@e.e@e@@e@e@e@e@e@e.e.....................................w",
        "..e@@e@e@e.e@e.e@e@e.e@...e@e@..................................e.e@e@e@@e@@e@@e@@e@@e@@e@@e@@e@e@@e..",
        "..............................e.e@e.e@e@e@e@e@e@e@.e@e@e@e.e@e.e@e....................................",
        "w.e@@e@e.e@e@e.e@e.e@ee@@ee@e@@e...................................e@ee@@e@e@@e@@ee@e@@e@e@@e@@e@e@..w",
        "..............................eee@e@e.e@e@e.e@e.e@@e@e@e.e@e@e.e@e@e@e................................",
        "..e@@e.e@e@e@e.e@e@e.e@@e@e@e@e@.........................................e@@e@@e@e@@e@@e@@e@e@@e@@e@..",
        "w.................................e@e@e.e@e.e@e.e@@e@e@..e@e@e.e@@ee@e...............................w",
        "..e@ee@e@e.e@e.e@e@ee@@e@@e@e@e..e........................................e.e@.@e@@e@@e@@e@@e@e@@e@...",
        "................................e@e.e@e@e@e@e.e@e@@e@ee@@e@e@e@e@e@e@e@ee@@e..........................",
        "w.e@@e@e@e.e@e.e@e@e@@e@e@e@e....e...........................................e@@e@e@@e@@e@@ee@@e@@e@.w",
        "................................e@e@e@e@e@e@e@e@e@@e@ee@@e@e@e.e@e@e@e@e@@e.e.........................",
        "..e@.e@e.e@e@e@e@e@e@@e@e@@e@@e@.e.........................................e@@e@@e@@e@@e@@e@@e@@e@e@..",
        "w.................................e@e.e@e.e@e@e.e@@e@e@..e@e@e@@e@ee@e@e@@e..........................w",
        "..e@@e.e@e@e@e@e@e@e@@e@e@.@e............................................e@e.e@@e@e@@e@@e@@e@@e@.@e@..",
        "..................................e@e@e@e@e@e.e@ee@e@e@.@e@e@ee@@e@e@@e.e.............................",
        "w.e@@e.e@e@e@e@e@e@ee@e@.e@@e@.@ee......................................@e.@e@@e@@e@@e@@e@@e@@e@@e@..w",
        ".................................@e@e@e@e@e@e@e@@e@e@.@e@e@@ee@@ee@e@@e...............................",
        "..e@@e@e@e@e.e@e@e@e@e@e@e@@ee@@ee....................................@e....e@.@e@@e@@e@@e@@e@@ee@@e..",
        "w...................................e@e.e@e.e@e@@e@ee@@e@e@@e@e@@e.@e................................w",
        "..e@@e@e@e@e@e.e@e@e.e@e@e@.e@.@e................................e@...@e@@e.@e@e@@e@@e@@e@e@e@@e@@e@..",
        "..................................e@e@e.e@e@e.e@@e@@e@@e@@e@@e..e..e..................................",
        "w.e@ee@e@e@e@e@e@e@e@e@e.e@@ee@@e..e.........................e@e@e@@@ee@@e@@ee@@ee@@e@@e@e@@e@e@@e@e.w",
        "...................................@e@e@e@e@e@e@@e@@e@@ee.e...........................................",
        "..e@@e@e.e@e@e@e@e@e@e@e@e@@e@@ee@.....................e@e@e@e@e@ee@.@e@@e@@e@@e@@e@@e@@e@e@@e@e@@e...",
        "w.................................e@e@e@e@e@e@e.@ee.e................................................w",
        "..@e.e@e.e@e@e.e@e@e@e@e@ee@@e@@e................e@e@e@e@e@e@e@e@@e@e@@e@@e@@e@e@@e@@e@@e@@ee@@e@@e@..",
        "....................................ee@e.e@ee.e.......................................................",
        "w.@e@e@e@e.e@e@e@e@e@e@e@e..@ee@@e..@......e@e@e@e.e@e.e@e@e@e@@e@@e@@e@@e@@e@e@@e@@e@@e@@e@.e@@e@@e.w",
        "......................................................................................................",
        "..@e@e.e@e@e.e@e@e@e@e.e@e@@e@.@e@@ee@@e.e@e.e@e@e@e@e@e@e.e@e@e@@e@@e@@e@@e@@e@@e@@e@@e@@e@e@@e@@e@..",
        "w....................................................................................................w",
        "...e@e@e@e@e.e@e@e@e@e@e@e.e@@e@@e@@e@@e@e@e@e@e@e@e@e@e@e@@e@@ee@@e@e@@e@@e@@e@@e@@e@e@@e@@e@@e@@e@..",
        "......................................................................................................",
        "w.@e.e@e@e@e@e@e@e@e.e@e@e@e@@e@@e@@e@@e@e@e@e@e.e@e.e@e@e@@e@@e@@e@e@e@@e@e@@e@@e@@e@@e@e@@e@@e@@e@.w",
        "......................................................................................................",
        "..@e@e@e.e@e@e@e.e@e.e@e..e@@e@@e@@e@@ee@e@e@e.e@e@e.e@e@@e@@e@@e@@e@e@@e.@e@@e@@e@@e@@e@e@....@e@e@..",
        "w....................................................................................................w",
        "..@e.e@e@e@e@e.e@e.e@e@ee@.e@@e@@e@@e@@e@e@e@e@e@e@e@e@@e@@e@.e@e@@e@@e@@e@@ee@e@@e@@e@@ee@@e@..e@e@..",
        "......................................................................................................",
        "w..e@e@e@e@e@e@e@e@e.e@@ee@@e@@e@e@@e@@e@e@e@e.e@e@@e@@e@@e@.@e@@e@@e@@e@e@@e@@e@e@@e@@e@@e@@e@@e@e@.w",
        "......................................................................................................",
        "...e@e@e@e@e.e@e@e.e@e@@ee@@e@e@@e@.e@@e@e@e@e@e@@e@@e@e@@e@@e@@e@e@@e@e@@e@@e@@e@@e@@e@@e@@e@@e@@e@..",
        "......................................................................................................"
    ],
    "nca_runtime": 0.18522143363952637,
    "milp_runtime": 70.58651661872864,
    "nca_milp_runtime": 70.77173805236816,
    "sim_score": null,
    "weight": false,
    "n_row": 101,
    "n_col": 102,
    "n_endpoint": 2016,
    "n_agent_loc": 0,
    "n_shelf": 2500,
    "maxtime": 5000
}
