{
    "name": "kiva_large_200_agents_cma-es_opt_entropy_uneven_throughput_hamming_a=5_n-emitter=5",
    "layout": [
        "...e................................",
        "w..@e.e@e@e@e@e@e@e@e@@e@@e@@e@@e@.w",
        "....................................",
        "..e@e@e.e@e@e@e@e@e@e@@e@@e@@e@@e...",
        "w..................................w",
        "..e@e.e@e.e@e@e@e@e@@e@@e@@e@@e@@e..",
        "....................................",
        "w...e@e.e@e.e@e@e@e@@e@@e@@e@@e@@e.w",
        "....................................",
        "..e@e@e.e@e.e@e@e@@e@@e@@e@e@@e@@e..",
        "w..................................w",
        "..e@e.e@e.e@e.e@ee@@e@@e@@e@@e@@e@..",
        "....................................",
        "w.e@e.e@e.e@e.e@ee@@e@@e@@e@@e@@e@.w",
        "....................................",
        "..e@e.e@e.e@e.e@e@e@@e@@e@@e@@e@@e..",
        "w..................................w",
        "..e@e.e@e.e@e.e@e@@ee@@e@@e@@e@@e@..",
        "....................................",
        "w.e@e.e@e.e@e.e@e..@e@@e@@e@@e@@e@.w",
        "....................................",
        "..e@e.e@e.e@e......@e@@e@@e@@e@@e@..",
        "w..................................w",
        "..e@e.e@e.e@e.........@e@@e@@e@@e@..",
        "....................................",
        "w.e@e.e@e.e@ee@.e@.@e@@e@@e@@e@@e@.w",
        "....................................",
        "..e@e.e@e.e@.e@.@e@@e@@e@@e@@e@@e@..",
        "w..................................w",
        "..e@e.e@e.e@.e@@e@.@e@@e@@e@@e@@e@..",
        "....................................",
        "w.e@e.e@e..e@e.@e@e@@e@@e@@e@@e@@e.w",
        "...................................."
    ],
    "nca_runtime": null,
    "milp_runtime": null,
    "nca_milp_runtime": null,
    "sim_score": null,
    "weight": false,
    "n_row": 33,
    "n_col": 36,
    "n_endpoint": 209,
    "n_agent_loc": 0,
    "n_shelf": 240,
    "maxtime": 5000
}