{
    "name": "kiva_large_200_agents_cma-me_opt_avg_turn",
    "weight": false,
    "n_row": 33,
    "n_col": 36,
    "n_endpoint": 305,
    "n_agent_loc": 0,
    "maxtime": 5000,
    "layout": [
        "..e.................................",
        "w.@e@e@e@e@e@e@e@e@e@e@e@e@e@e@e@e.w",
        "...e................................",
        "..e@eee.ee.ee.ee.ee.eee@e@e@ee@e@e..",
        "w..@e@@e@@e@@e@@e@@e@@e.e..........w",
        "...e....................@e@e@e@e@e..",
        "..e@e@e@e.ee.ee.ee.ee.eee...........",
        "w........e@@e@@e@@e@@e@@e@e@ee@e@e.w",
        "..eee@eee...........................",
        "..@@e@e@@ee@e@e@e@e@e@ee@e@e@e@e@e..",
        "w.e................................w",
        "..e.ee.ee.ee.ee.ee.ee.ee.ee.ee.ee...",
        "..@e@@e@@e@@e@@e@@e@@e@@e@@e@@e@@e..",
        "w.e................................w",
        "..@e@e@e@e@e@e@e@e@e@e@e@e@e@e@e@e..",
        "...e................................",
        "w..@e@e@e@e@e@e@e@e@e@ee@e@e@e@e@e.w",
        "...e................................",
        "..e@e@e@e@e@e@e@e@ee@e@e@e@e@e@e@e..",
        "w..e...............................w",
        "..@e@e@e@e@e@e@e@e@e@e@e@e@e@e@e@e..",
        "..e.................................",
        "w.ee.ee.ee.ee.ee.eee@eee.ee.ee.ee..w",
        "..@@e@@e@@e@@e@@e@@e@e@@e@@e@@e@@e..",
        "..e.................................",
        "w.@e@e@e@e@e@e@e@e@e@e@e@e@e@e@e@e.w",
        "...e................................",
        "...@e@e@e@e@e@e@e@e@ee@e@e@e@e@e@e..",
        "w..................................w",
        "..@e@e@ee@e@e@e@e@e@ee@e@e@e@e@e@e..",
        "..e.................................",
        "w.@e@e@e@e@e@e@e@e@e.e@e@e@e@e@e@e.w",
        "...................................."
    ]
}