{
    "name": "kiva_xxlarge_cma-mae_entropy_throughput_hamming_a=5_s_train_mid",
    "layout": [
        "......................................................................................................",
        "w.@e@@@@@@@@@@@@@@@@@@@@@@@@@@@@@@@@@@@@@@@@@@@@@@@@@@@@@@@@@@@@@@@@@@@@@@@@@@@@@@@@@@@@@@@@@@@@@@@..w",
        "....eeeeeeeeeeeeeeeeeeeeeeeeeeeeeeeeeeeeeeeeeeeeeeeeeeeeeeeeeeeeeeeeeeeeeeeeeeeeeeeeeeeeeeeeeeeeeee...",
        "......................................................................................................",
        "w.e@@.@.@@@@@@@@@@@@@@@@@@@@@@@@@@@@@@@@@@@@@@@@@@@@@@@@@@@@@@@@@@@@@@@@@@@@@@@@@@@@@@@@@@@@@@@.@.@..w",
        "....e.e.eeeeeeeeeeeeeeeeeeeeeeeeeeeeeeeeeeeeeeeeeeeeeeeeeeeeeeeeeeeeeeeeeeeeeeeeeeeeeeeeeeeeeee.e.e...",
        "......................................................................................................",
        "w.e@@.@.@.@@@@@@@@@@@@@@@@@@@@@@@@@@@@@@@@@@@@@@@@@@@@@@@@@@@@@@@@@@@@@@@@@@@@@@@@@@@@@@@@@@@.@.@.@..w",
        "....e.e.e.eeeeeeeeeeeeeeeeeeeeeeeeeeeeeeeeeeeeeeeeeeeeeeeeeeeeeeeeeeeeeeeeeeeeeeeeeeeeeeeeeee.e.e.e...",
        "......................................................................................................",
        "w.e@@.@.@.@.@.@@@@@@@@@@@@@@@@@@@@@@@@@@@@@@@@@@@@@@@@@@@@@@@@@@@@@@@@@@@@@@@@@@@@@@@@@@@.@.@.@.@.@..w",
        "....e.e.e.e.e.eeeeeeeeeeeeeeeeeeeeeeeeeeeeeeeeeeeeeeeeeeeeeeeeeeeeeeeeeeeeeeeeeeeeeeeeeee.e.e.e.e.e...",
        "......................................................................................................",
        "w.e@@.@@e@@e@.@.@@@@@@@@@@@@@@@@@@@@@@@@@@@@@@@@@@@@@@@@@@@@@@@@@@@@@@@@@@@@@@@@@@@@@@@.@.@.@.@.@.@..w",
        "....e.e...e.e.e.eeeeeeeeeeeeeeeeeeeeeeeeeeeeeeeeeeeeeeeeeeeeeeeeeeeeeeeeeeeeeeeeeeeeeee.e.e.e.e.e.e...",
        "......................................................................................................",
        "w.e@@.@@e@@@e@@@e@@.@@@@@@@@@@@@@@@@@@@@@@@@@@@@@@@@@@@@@@@@@@@@@@@@@@@@@@@@@@@@@@@.@@e@@.@.@.@.@.@..w",
        "....e.e...e...e...e.eeeeeeeeeeeeeeeeeeeeeeeeeeeeeeeeeeeeeeeeeeeeeeeeeeeeeeeeeeeeeee.e...e.e.e.e.e.e...",
        "......................................................................................................",
        "w.@e@.@@e@@.@.@@e@@.@.@@@@@@@@@@@@@@@@@@@@@@@@@@@@@@@@@@@@@@@@@@@@@@@@@@@@@@@@@@@.@.@.@.@.@.@.@.@.@..w",
        "....e.e...e.e.e@e.e.e.eeeeeeeeeeeeeeeeeeeeeeeeeeeeeeeeeeeeeeeeeeeeeeeeeeeeeeeeeee.e.e.e.e.e.e.e.e.e...",
        "...........e..........................................................................................",
        "w.@e@@@.@.@@@.@@e@@@e@@.@.@@@@@@@@@@@@@@@@@@@@@@@@@@@@@@@@@@@@@@@@@@@@@@@@@@@.@.@.@@e@@.@.@.@.@.@.@..w",
        "....eee.e.e.e.e.e.e.e.e.e.eeeeeeeeeeeeeeeeeeeeeeeeeeeeeeeeeeeeeeeeeeeeeeeeeee.e.e.e.e@e.e.e.e.e.e.e...",
        "................@...@.................................................................................",
        "w.e@@.@.@.@.@.@e@.@.@.@.@.@.@@@@@@@@@@@@@@@@@@@@@@@@@@@@@@@@@@@@@@@@@@@@@@@@e@@.@.@.@.@.@@e@@.@@e@@..w",
        "....e.e.e.e.e.e.e.e.e.e.e.e.eeeeeeeeeeeeeeeeeeeeeeeeeeeeeeeeeeeeeeeeeeeeeee...e.e.e.e.e.e...e.e...e...",
        "......................................................................................................",
        "w.e@@.@.@.@.@.@.@.@.@.@.@.@.@.@.@@@@@@@@@@@@@@@@@@@@@@@@@@@@@@@@@@@@@@@.@e@.@.@.@.@@e@e@@.@.@.@.@.@..w",
        "....e.e.e.e.e.e.e.e.e.e.e.e.e.e.eeeeeeeeeeeeeeeeeeeeeeeeeeeeeeeeeeeeeee.e.e.e.e.e.e.e@e.e.e.e.e.e.e...",
        "......................................................................................................",
        "w.@e@.@.@.@.@.@.@.@@e@@.@.@.@@e@@.@@@@@@@@@@@@@@@@@@@@@@@@@@@@@@@@@@@.@.@.@e@.@.@.@.@.@.@e@.@.@.@@@..w",
        "....e.e.e.e.e.e.e.e@e.e.e.e.e...e.eeeeeeeeeeeeeeeeeeeeeeeeeeeeeeeeeee.e.e.e.e.e.e.e.e.e.e.e.e.e.eee...",
        "......................................................................................................",
        "w.@e@.@.@.@.@.@.@.@@e@@.@@e@@.@@e@@.@.@@@@@@@@@@@@@@@@@@@@@@@@@@@.@.@.@e@.@.@.@.@.@.@.@.@.@.@.@.@.@..w",
        "....e.e.e.e.e.e.e.e...e.e...e.e@e.e.e.eeeeeeeeeeeeeeeeeeeeeeeeeee.e.e.e.e.e.e.e.e.e.e.e.e.e.e.e.e.e...",
        "......................................................................................................",
        "w.@e@.@.@.@.@.@.@.@.@e@.@.@.@@e@@.@.@@e@@@@@@@@@@@@@@@@@@@@@@@@.@.@.@.@e@.@e@.@.@.@.@.@.@@e@@@e@@.@..w",
        "....e.e.e.e.e.e.e.e.e.e.e.e.e...e.e.e...eeeeeeeeeeeeeeeeeeeeeee.e.e.e.e.e.e.e.e.e.e.e.e.e...e...e.e...",
        "...........................e...................................e......................................",
        "w.@e@.@.@.@.@.@.@.@.@.@.@.@@@.@.@@e@@.@@e@@.@@@@@@@@@@@@@@@.@.@@@@@.@.@.@.@.@.@e@.@.@.@@e@@.@@e@@.@..w",
        "....e.e.e.e.e.e.e.e.e.e.e.e.e.e.e...e.e...e.eeeeeeeeeeeeeee.e.e.eee.e.e.e.e.e.e.e.e.e.e.e.e.e.e@e.e...",
        "...............................................................e........................@.............",
        "w.e@@.@.@.@e@.@.@e@@e@@e@.@@e@@.@.@@@.@@e@@.@.@@@@@@@@@@@.@@e@@@@@e@@.@.@.@.@.@.@.@@e@@.@.@@e@@.@.@..w",
        "....e.e.e.e.e.e.e.e.e.e.e.e.e.e.e.eee.e.e@e.e.eeeeeeeeeee.e.e.e.e.e.e.e.e.e.e.e.e.e.e.e.e.e.@.e.e.e...",
        "....................@.......@....................e..........@.....@.................@.................",
        "w.@e@.@.@.@.@.@.@.@@e@@@@@e@@@e@@.@.@.@@e@@.@.@@@@@@@@e@@@@@e@@.@@e@@@e@@e@.@.@@e@@.@.@.@.@e@.@.@.@..w",
        "....e.e.e.e.e.e.e.e.e.eee.e.e.e.e.e.e.e.e.e.e.eee.eee.e@eee.e.e.e...e.e.e.e.e.e@e.e.e.e.e.e.e.e.e.e...",
        "...............e....@.....@...@..e......@...................@.........@...............................",
        "w.e@@.@.@.@@e@@@@.@.@@e@@@@@e@@@@@@.@e@.@.@.@.@@e@@@e@@.@@e@@.@@e@@@@.@.@.@.@.@.@.@@e@@.@.@.@.@@e@@..w",
        "....e.e.e.e...e.e.e.e...eee.e.eee.e.e.e.e.e.e.e...e...e.e.e@e.e...eee.e.e.e.e.e.e.e.e.e.e.e.e.e.e@e...",
        ".....e...e..................@..............................e.........e..............@.................",
        "w.e@@@@@@@@.@.@.@.@.@e@.@.@.@.@.@.@@e@e@@@e@@.@@e@@.@.@.@@@@@.@@@.@.@@@.@@e@@.@.@@e@@.@.@.@.@.@.@.@..w",
        "....e.eee.e.e.e.e.e.e.e.e.e.e.e.e.e.e@e.e...e.e.e.e.e.e.eee.e.eee.e.e.e.e.e.e.e.e.e.e.e.e.e.e.e.e.e...",
        ".....e.e........................................@.........................@.......@...................",
        "w.@e@@@@@@e@@.@@e@@@e@@.@.@@e@@@@@e@@@e@@@@@e@@.@e@.@.@.@@e@@@@@e@@.@@e@@.@.@.@.@.@.@.@.@.@.@.@.@.@..w",
        "....e.e.e.e@e.e.e.e...e.e.e...eee.e.e.e.eee.e.e.e.e.e.e.e.e.eee...e.e.e.e.e.e.e.e.e.e.e.e.e.e.e.e.e...",
        "................@.................@...@.....@..........e..@....e......@...............................",
        "w.@e@.@.@@e@@@e@e@@.@.@.@.@e@.@.@e@@e@@@e@@.@@e@@.@@e@@@@@e@@.@@@@e@@@e@@@e@@.@.@.@.@.@.@e@.@@e@@.@..w",
        "....e.e.e...e.e@e.e.e.e.e.e.e.e.e.e.e.e.e.e.e...e.e.e.e.e...e.e.e.e.e.e.e.e.e.e.e.e.e.e.e.e.e.e.e.e...",
        "....................................@...@...........@e............@...@...@...................@.......",
        "w.e@@.@e@@e@@@@@e@@.@e@.@@e@@.@@e@@.@.@@e@@@@@e@@.@.@@@@e@@.@@@@e@@.@.@@e@@@@@e@@e@.@@e@@.@.@.@@e@@..w",
        "....e.e.e.e.eee.e.e.e.e.e.e.e.e...e.e.e.e.eee.e.e.e.e.e.e.e.eee...e.e.e.e.eee.e.e.e.e.e.e.e.e.e.e.e...",
        "..........@.....@.........@.............@.....@.........@...............@e....@.......@.........@.....",
        "w.@e@.@@e@@.@.@.@.@.@@e@@@e@@.@.@@e@@@e@@.@.@@e@@.@.@@e@@.@@e@@@@@@.@@e@@@@.@.@.@.@@e@@@e@@.@.@.@.@..w",
        "....e.e...e.e.e.e.e.e.e.e.e.e.e.e@e.e...e.e.e.e.e.e.e.e.e.e.e.eeeee.e.@.e.e.e.e.e.e.e.e.e.e.e.e.e.e...",
        "...............e...e..@...@....e..............@.......@.....@.......................@...@.............",
        "w.e@@.@.@.@@@.@@@.@@@.@.@e@@e@@@@.@.@@e@@@e@@@@@e@@@@@e@@@@@e@@@e@@@@@e@@@e@@@@@e@@.@.@.@.@.@.@.@.@..w",
        "....e.e.e.eee.e.e.e.e.e.e.e.e.e.e.e.e.e.e.e.eee.e.eee.e.eee.e.e.e.eee.e.e.e.eee.e.e.e.e.e.e.e.e.e.e...",
        "............................@.........@...@.....@.....@.....@...@.....@..e@..e..@.....................",
        "w.e@@.@.@.@.@.@@e@@.@@e@@@e@e@@.@@e@@.@.@@e@@@@@e@@@e@@@@@e@@@@@@.@.@@e@@@@.@@@.@.@.@@e@@.@.@.@@e@@..w",
        "....e.e.e.e.e.e.e.e.e...e.e@e.e.e.e.e.e.e.e.eee.e.e.e.eee.e.eeeee.e.e.e@e.e.e.e.e.e.e.e.e.e.e.e.@.e...",
        "................@.................@.......@..e..@...@.....@......e....................@...............",
        "w.@e@@@e@@e@@@e@@@e@@.@.@.@.@.@.@@e@@@e@@@e@@@@.@@e@@@e@@@e@@.@.@@@@e@@@e@@@e@@.@.@.@.@.@.@@e@@.@.@..w",
        "....eee.e...e...e...e.e.e.e.e.e.e...e.@.e.e.e.e.e...e@e.e.e.e.e.e.e.e.e.e.e...e.e.e.e.e.e.e.e.e.e.e...",
        "..........................................@...............@e........@..e@...................@.........",
        "w.e@@.@@@@e@@@e@@e@.@.@@e@@@e@@.@@e@@@e@@@e@@.@.@.@@e@@@e@@@@@e@@.@@e@@@@@e@e@@@e@@@@@e@@.@.@.@.@.@..w",
        "....e.eee.@.e.@.e.e.e.e@e.e@e.e.e...e.e.e.e.e.e.e.e.@.e.@.e.e.@.e.e.e.e.e.e@e.e.e.eee.e.e.e.e.e.e.e...",
        ".........e............................@...@.........................@...........@.....@...............",
        "w.e@@.@.@@@@e@e@@.@@e@@.@.@@e@@@e@@e@.@@e@@.@.@@e@@.@.@.@.@.@@e@@.@@e@e@@@e@@@e@@.@.@.@@e@@.@.@@e@@@.w",
        "....e.e.e.e.e@e.e.e.e.e.e.e.@.e...e.e.e.e.e.e.e...e.e.e.e.e.e.e.e.e.e@e.e...e@e.e.e.e.e.e.e.e.e.e.ee..",
        "....................@...................@.....................@..e......................@.......@.....",
        "w.e@@.@.@@e@@@e@@e@.@@e@e@@.@e@.@@e@@@e@@.@e@@e@@@@@e@@e@.@@e@@@@@@@e@@@e@@.@@e@@.@.@.@@e@@.@.@@e@@..w",
        "....e.e.e.@.e...e.e.e.e@e.e.e.e.e@e.e.@.e.e.e.@.eee.e.e.e.e.e.eee.e...e.e@e.e...e.e.e.e.e.e.e.e...e...",
        "....................................................@..e.e..@....e......................@.............",
        "w.e@@@e@@.@.@e@.@.@@e@@.@@e@@.@.@.@@e@@@e@@@e@@.@.@.@.@@@@@e@@e@@@@@e@@@e@@@@.@@e@@.@.@.@.@.@.@.@.@..w",
        "....e...e.e.e.e.e.e...e.e...e.e.e.e...e...e...e.e.e.e.e.e.e.e...e.e.e.e.e.eee.e...e.e.e.e.e.e.e.e.e...",
        "....................................................................@...@.............................",
        "w.e@@.@.@.@@e@@@e@@.@.@.@.@.@.@@e@@.@.@.@.@@e@@.@.@.@@e@@@@.@@@e@@e@@.@@e@@.@.@.@.@.@@@e@.@.@@e@@.@..w",
        "....e.e.e.e.e@e@e.e.e.e.e.e.e.e...e.e.e.e.e...e.e.e.e...eee.eee.e...e.e...e.e.e.e.e.eee.e.e.e...e.e...",
        "...........................................................e.......e..................................",
        "w.e@@.@e@.@.@.@.@.@@e@@e@e@.@.@.@.@.@.@.@@e@@.@.@@e@@.@@@.@@@.@@e@@@@.@@e@@.@@e@@.@@e@@@e@@@e@@.@@e@.w",
        "....e.e.e.e.e.e.e.e...e.e.e.e.e.e.e.e.e.e...e.e.e...e.eee.e.e.e...e.e.e...e.e...e.e.e.e@e.e...e.e.....",
        ".........................e...e......................................................@.................",
        "w.e@@.@@@.@.@.@@e@@.@@e@@@@.@@@@e@@.@.@.@.@.@.@.@@e@@@e@@@@.@.@.@.@@e@@.@.@@e@@.@.@.@.@.@.@@e@@.@@e@.w",
        "....e.eee.e.e.e...e.e...e.e.e.e...e.e.e.e.e.e.e.e...e...eee.e.e.e.e...e.e.e...e.e.e.e.e.e.e...e.e.....",
        "...........................................e...............................e..........................",
        "w.@e@.@.@.@@e@@.@.@.@.@.@.@.@.@.@.@.@.@.@.@@@.@@e@@@e@@.@.@@e@@.@@e@e@@@e@@@@.@.@.@.@@e@@@e@@@@.@@e@.w",
        "....e.e.e.e...e.e.e.e.e.e.e.e.e.e.e.e.e.e.e.e.e...e...e.e.e...e.e.e@e.e...e.e.e.e.e.e...e...eee.e.....",
        "......................................................................................................",
        "..@e@@e@@e@@e@@e@@e@@e@@e@@e@@e@@e@@e@@e@@e@@e@@e@@e@@e@e@@e@@e@@e@@e@@e@@e@@e@@e@@e@@e@@e@@e@@e@@e@.."
    ],
    "nca_runtime": 0.5082340240478516,
    "milp_runtime": 3325.793308734894,
    "nca_milp_runtime": 3326.3015427589417,
    "sim_score": null,
    "weight": false,
    "n_row": 101,
    "n_col": 102,
    "n_endpoint": 2283,
    "n_agent_loc": 0,
    "n_shelf": 2500,
    "maxtime": 5000
}