{
    "name": "kiva_large_cma-mae_entropy_throughput_hamming_a=5_s_train_mid",
    "layout": [
        "....................................",
        "w.e@@@@@@@@@@@@@@@@@@@@@@@@@@@@@@..w",
        "....eeeeeeeeeeeeeeeeeeeeeeeeeeeee...",
        "....................................",
        "w.@e@.@.@@@@@@@@@@@@@@@@@@@@@.@.@..w",
        "....e.e.eeeeeeeeeeeeeeeeeeeee.e.e...",
        "....................................",
        "w.@e@.@e@.@@@@@@@@@@@@@@@@@.@.@e@e.w",
        "....e.e.e.eeeeeeeeeeeeeeeee.e.e.e...",
        "....................................",
        "w.e@@.@.@e@.@e@@@@@@@@@e@.@.@.@.@..w",
        "....e.e.e.e.e.eeeeeeeee.e.e.e.e.e...",
        "....................................",
        "w.@e@.@.@.@e@@@e@@@@@e@.@.@.@.@e@e.w",
        "....e.e.e.e.eee.eeeee.e.e.e.e.e.e...",
        "....................................",
        "w.e@@.@.@e@.@.@.@e@@e@e@@.@.@.@.@..w",
        "....e.e.e.e.e.e.e.e.e@e.e.e.e.e.e...",
        "....................................",
        "w.e@@.@e@.@.@.@e@e@.@@e@@e@.@e@.@..w",
        "....e.e.e.e.e.e.e.e.e.e@e.e.e.e.e...",
        "....................................",
        "w.e@@.@.@@e@@.@e@.@.@.@@e@e@@@@.@..w",
        "....e.e.e.e.e.e.e.e.e.e.e@e.eee.e...",
        "..........@.........................",
        "w.e@@@e@@e@@e@@@e@@@e@@e@.@e@.@.@..w",
        "....e.e.e.e.e@e.e@e.e@e.e.e.e.e.e...",
        "......@.............................",
        "w.......@e@@@@e@@e@e@e@@@@e@@.@.@e.w",
        "...@.@..e.eee.e@e.e.e.eee@e.e.e.e...",
        "...e.e..............................",
        "w.....@e@.@e@.@e@@e@e@@@e@@.@.@.@..w",
        "..e@..e.e.e.e.e.e.e@e.e@e.e.e.e.e..."
    ],
    "nca_runtime": 0.14481091499328613,
    "milp_runtime": 70.12450528144836,
    "nca_milp_runtime": 70.26931619644165,
    "sim_score": null,
    "weight": false,
    "n_row": 33,
    "n_col": 36,
    "n_endpoint": 261,
    "n_agent_loc": 0,
    "n_shelf": 240,
    "maxtime": 5000
}