{
    "name": "kiva_large_cma-mae_entropy_throughput_hamming_a=5_s_train_mid_unrepaired",
    "layout": [
        "....................................",
        "w.@@@@@@@@@@@@@@@@@@@@@@@@@@@@@@@@.w",
        "....eeeeeeeeeeeeeeeeeeeeeeeeeeeee...",
        "....................................",
        "w.@@@@@@@@@@@@@@@@@@@@@@@@@@@@@@@@.w",
        "....e.e.eeeeeeeeeeeeeeeeeeeee.e.e...",
        "....................................",
        "w.@@@@@@@@@@@@@@@@@@@@@@@@@@@@@@@@.w",
        "....e.e.e.eeeeeeeeeeeeeeeee.e.e.e...",
        "....................................",
        "w.@@@@@@@@@@@@@@@@@@@@@@@@@@@@@@@@.w",
        "....e.e.e.e.e.eeeeeeeee.e.e.e.e.e...",
        "....................................",
        "w.@@@@@@@@@@@@@@@@@@@@@@@@@@@@@@@@.w",
        "....e.e.e.e.e.e.eeeee.e.e.e.e.e.e...",
        "....................................",
        "w.@@@@@@@@@@@@@@@@@@@@@@@@@@@@@@@@.w",
        "....e.e.e.e.e.e.e.e.e.e.e.e.e.e.e...",
        "....................................",
        "w.@@@@@@@@@@@@@@@@@@@@@@@@@@@@@@@@.w",
        "....e.e.e.e.e.e.e.e.e.e.e.e.e.e.e...",
        "....................................",
        "w.@@@@@@@@@@@@@@@@@@@@@@@@@@@@@@@@.w",
        "....e.e.e.e.e.e.e.e.e.e.e.e.e.e.e...",
        "....................................",
        "w.@@@@@@@@@@@@@@@@@@@@@@@@@@@@@@@@.w",
        "....e.e.e.e.e.e.e.e.e.e.e.e.e.e.e...",
        "......e.............................",
        "w......@@@@@@@@@@@@@@@@@@@@@@@@@@@.w",
        "..@@@@..e.e.e.e.e.e.e.e.e.e.e.e.e...",
        "...e.e..............................",
        "w.....@@@@@@@@@@@@@@@@@@@@@@@@@@@@.w",
        "..e@..e.e.e.e.e.e.e.e.e.e.e.e.e.e..."
    ],
    "nca_runtime": 0.14481091499328613,
    "milp_runtime": null,
    "nca_milp_runtime": null,
    "sim_score": null,
    "weight": false,
    "n_row": 33,
    "n_col": 36,
    "n_endpoint": 204,
    "n_agent_loc": 0,
    "n_shelf": 348,
    "maxtime": 5000
}