{
    "name": "kiva_xxlarge_cma-mae_global_opt_repaired_one_endpt_throughput-hamming_a=5_iter=500",
    "weight": false,
    "n_row": 101,
    "n_col": 102,
    "n_endpoint": 40,
    "n_agent_loc": 40,
    "maxtime": 5000,
    "layout": [
        "......................................................................................................",
        "w.e@ee@@ee@@ee@@ee@@ee@@ee@@ee@@ee@@ee@@ee@@ee@@ee@@ee@@ee@@ee@@ee@@ee@@ee@@ee@@ee@@ee@@ee@@ee@@eee@.w",
        ".................................................................................................@....",
        "..@@ee@@ee@@ee@@ee@@ee@@ee@@ee@@ee@@ee@@ee@@ee@@ee@@ee@@ee@@ee@@ee@@ee@@ee@@ee@@ee@@ee@@ee@@ee@@e@ee..",
        "w.e................................................................................................@.w",
        "..@@ee@@ee@@ee@@ee@@ee@@ee@@ee@@ee@@ee@@ee@@ee@@ee@@ee@@ee@@ee@@ee@@ee@@ee@@ee@@ee@@ee@@ee@@ee@@eee@..",
        ".................................................................................................@.e..",
        "w.@@ee@@ee@@ee@@ee@@ee@@ee@@ee@@ee@@ee@@ee@@ee@@ee@@ee@@ee@@ee@@ee@@ee@@ee@@ee@@ee@@ee@@ee@@ee@@ee@@.w",
        "..e...................................................................................................",
        "..@@ee@@ee@@ee@@ee@@ee@@ee@@ee@@ee@@ee@@ee@@ee@@ee@@ee@@ee@@ee@@ee@@ee@@ee@@ee@@ee@@ee@@ee@@ee@@ee@e..",
        "w....................................................................................................w",
        "..@@ee@@ee@@ee@@ee@@ee@@ee@@ee@@ee@@ee@@ee@@ee@@ee@@ee@@ee@@ee@@ee@@ee@@ee@@ee@@ee@@ee@@ee@@ee@@eee@..",
        "..e..............................................................................................@.e..",
        "w.@@ee@@ee@@ee@@ee@@ee@@ee@@ee@@ee@@ee@@ee@@ee@@ee@@ee@@ee@@ee@@ee@@ee@@ee@@ee@@ee@@ee@@ee@@ee@@ee@@.w",
        "......................................................................................................",
        "..@@ee@@ee@@ee@@ee@@ee@@ee@@ee@@ee@@ee@@ee@@ee@@ee@@ee@@ee@@ee@@ee@@ee@@ee@@ee@@ee@@ee@@ee@@ee@@ee@e..",
        "w.e..................................................................................................w",
        "..@@ee@@ee@@ee@@ee@@ee@@ee@@ee@@ee@@ee@@ee@@ee@@ee@@ee@@ee@@ee@@ee@@ee@@ee@@ee@@ee@@ee@@ee@@ee@@eee@..",
        ".................................................................................................@.e..",
        "w.@@ee@@ee@@ee@@ee@@ee@@ee@@ee@@ee@@ee@@ee@@ee@@ee@@ee@@ee@@ee@@ee@@ee@@ee@@ee@@ee@@ee@@ee@@ee@@ee@@.w",
        "..e...................................................................................................",
        "..@@ee@@ee@@ee@@ee@@ee@@ee@@ee@@ee@@ee@@ee@@ee@@ee@@ee@@ee@@ee@@ee@@ee@@ee@@ee@@ee@@ee@@ee@@ee@@ee@e..",
        "w....................................................................................................w",
        "..@@ee@@ee@@ee@@ee@@ee@@ee@@ee@@ee@@ee@@ee@@ee@@ee@@ee@@ee@@ee@@ee@@ee@@ee@@ee@@ee@@ee@@ee@@ee@@eee@..",
        "..e..............................................................................................@.e..",
        "w.@@ee@@ee@@ee@@ee@@ee@@ee@@ee@@ee@@ee@@ee@@ee@@ee@@ee@@ee@@ee@@ee@@ee@@ee@@ee@@ee@@ee@@ee@@ee@@ee@@.w",
        "......................................................................................................",
        "..@@ee@@ee@@ee@@ee@@ee@@ee@@ee@@ee@@ee@@ee@@ee@@ee@@ee@@ee@@ee@@ee@@ee@@ee@@ee@@ee@@ee@@ee@@ee@@ee@e..",
        "w.e..................................................................................................w",
        "..@@ee@@ee@@ee@@ee@@ee@@ee@@ee@@ee@@ee@@ee@@ee@@ee@@ee@@ee@@ee@@ee@@ee@@ee@@ee@@ee@@ee@@ee@@ee@@eee@..",
        ".................................................................................................@.e..",
        "w.@@ee@@ee@@ee@@ee@@ee@@ee@@ee@@ee@@ee@@ee@@ee@@ee@@ee@@ee@@ee@@ee@@ee@@ee@@ee@@ee@@ee@@ee@@ee@@ee@@.w",
        "..e...................................................................................................",
        "..@@ee@@ee@@ee@@ee@@ee@@ee@@ee@@ee@@ee@@ee@@ee@@ee@@ee@@ee@@ee@@ee@@ee@@ee@@ee@@ee@@ee@@ee@@ee@@ee@e..",
        "w....................................................................................................w",
        "..@@ee@@ee@@ee@@ee@@ee@@ee@@ee@@ee@@ee@@ee@@ee@@ee@@ee@@ee@@ee@@ee@@ee@@ee@@ee@@ee@@ee@@ee@@ee@@eee@..",
        "..e..............................................................................................@.e..",
        "w.@@ee@@ee@@ee@@ee@@ee@@ee@@ee@@ee@@ee@@ee@@ee@@ee@@ee@@ee@@ee@@ee@@ee@@ee@@ee@@ee@@ee@@ee@@ee@@ee@@.w",
        "......................................................................................................",
        "..@@ee@@ee@@ee@@ee@@ee@@ee@@ee@@ee@@ee@@ee@@ee@@ee@@ee@@ee@@ee@@ee@@ee@@ee@@ee@@ee@@ee@@ee@@ee@@ee@e..",
        "w.e..................................................................................................w",
        "..@@ee@@ee@@ee@@ee@@ee@@ee@@ee@@ee@@ee@@ee@@ee@@ee@@ee@@ee@@ee@@ee@@ee@@ee@@ee@@ee@@ee@@ee@@ee@@eee@..",
        ".................................................................................................@.e..",
        "w.@@ee@@ee@@ee@@ee@@ee@@ee@@ee@@ee@@ee@@ee@@ee@@ee@@ee@@ee@@ee@@ee@@ee@@ee@@ee@@ee@@ee@@ee@@ee@@ee@@.w",
        "..e...................................................................................................",
        "..@@ee@@ee@@ee@@ee@@ee@@ee@@ee@@ee@@ee@@ee@@ee@@ee@@ee@@ee@@ee@@ee@@ee@@ee@@ee@@ee@@ee@@ee@@ee@@ee@e..",
        "w....................................................................................................w",
        "..@@ee@@ee@@ee@@ee@@ee@@ee@@ee@@ee@@ee@@ee@@ee@@ee@@ee@@ee@@ee@@ee@@ee@@ee@@ee@@ee@@ee@@ee@@ee@@eee@..",
        "..e..............................................................................................@.e..",
        "w.@@ee@@ee@@ee@@ee@@ee@@ee@@ee@@ee@@ee@@ee@@ee@@ee@@ee@@ee@@ee@@ee@@ee@@ee@@ee@@ee@@ee@@ee@@ee@@ee@@.w",
        "......................................................................................................",
        "..@@ee@@ee@@ee@@ee@@ee@@ee@@ee@@ee@@ee@@ee@@ee@@ee@@ee@@ee@@ee@@ee@@ee@@ee@@ee@@ee@@ee@@ee@@ee@@ee@e..",
        "w.e..................................................................................................w",
        "..@@ee@@ee@@ee@@ee@@ee@@ee@@ee@@ee@@ee@@ee@@ee@@ee@@ee@@ee@@ee@@ee@@ee@@ee@@ee@@ee@@ee@@ee@@ee@@eee@..",
        ".................................................................................................@.e..",
        "w.@@ee@@ee@@ee@@ee@@ee@@ee@@ee@@ee@@ee@@ee@@ee@@ee@@ee@@ee@@ee@@ee@@ee@@ee@@ee@@ee@@ee@@ee@@ee@@ee@@.w",
        "..e...................................................................................................",
        "..@@ee@@ee@@ee@@ee@@ee@@ee@@ee@@ee@@ee@@ee@@ee@@ee@@ee@@ee@@ee@@ee@@ee@@ee@@ee@@ee@@ee@@ee@@ee@@ee@e..",
        "w....................................................................................................w",
        "..@@ee@@ee@@ee@@ee@@ee@@ee@@ee@@ee@@ee@@ee@@ee@@ee@@ee@@ee@@ee@@ee@@ee@@ee@@ee@@ee@@ee@@ee@@ee@@eee@..",
        "..e..............................................................................................@.e..",
        "w.@@ee@@ee@@ee@@ee@@ee@@ee@@ee@@ee@@ee@@ee@@ee@@ee@@ee@@ee@@ee@@ee@@ee@@ee@@ee@@ee@@ee@@ee@@ee@@ee@@.w",
        "......................................................................................................",
        "..@@ee@@ee@@ee@@ee@@ee@@ee@@ee@@ee@@ee@@ee@@ee@@ee@@ee@@ee@@ee@@ee@@ee@@ee@@ee@@ee@@ee@@ee@@ee@@ee@e..",
        "w.e..................................................................................................w",
        "..@@ee@@ee@@ee@@ee@@ee@@ee@@ee@@ee@@ee@@ee@@ee@@ee@@ee@@ee@@ee@@ee@@ee@@ee@@ee@@ee@@ee@@ee@@ee@@eee@..",
        ".................................................................................................@.e..",
        "w.@@ee@@ee@@ee@@ee@@ee@@ee@@ee@@ee@@ee@@ee@@ee@@ee@@ee@@ee@@ee@@ee@@ee@@ee@@ee@@ee@@ee@@ee@@ee@@ee@@.w",
        "..e...................................................................................................",
        "..@@ee@@ee@@ee@@ee@@ee@@ee@@ee@@ee@@ee@@ee@@ee@@ee@@ee@@ee@@ee@@ee@@ee@@ee@@ee@@ee@@ee@@ee@@ee@@ee@e..",
        "w....................................................................................................w",
        "..@@ee@@ee@@ee@@ee@@ee@@ee@@ee@@ee@@ee@@ee@@ee@@ee@@ee@@ee@@ee@@ee@@ee@@ee@@ee@@ee@@ee@@ee@@ee@@eee@..",
        "..e..............................................................................................@.e..",
        "w.@@ee@@ee@@ee@@ee@@ee@@ee@@ee@@ee@@ee@@ee@@ee@@ee@@ee@@ee@@ee@@ee@@ee@@ee@@ee@@ee@@ee@@ee@@ee@@ee@@.w",
        "......................................................................................................",
        "..@@ee@@ee@@ee@@ee@@ee@@ee@@ee@@ee@@ee@@ee@@ee@@ee@@ee@@ee@@ee@@ee@@ee@@ee@@ee@@ee@@ee@@ee@@ee@@ee@e..",
        "w.e..................................................................................................w",
        "..@@ee@@ee@@ee@@ee@@ee@@ee@@ee@@ee@@ee@@ee@@ee@@ee@@ee@@ee@@ee@@ee@@ee@@ee@@ee@@ee@@ee@@ee@@ee@@eee@..",
        ".................................................................................................@.e..",
        "w.@@ee@@ee@@ee@@ee@@ee@@ee@@ee@@ee@@ee@@ee@@ee@@ee@@ee@@ee@@ee@@ee@@ee@@ee@@ee@@ee@@ee@@ee@@ee@@ee@@.w",
        "..e...................................................................................................",
        "..@@ee@@ee@@ee@@ee@@ee@@ee@@ee@@ee@@ee@@ee@@ee@@ee@@ee@@ee@@ee@@ee@@ee@@ee@@ee@@ee@@ee@@ee@@ee@@ee@e..",
        "w....................................................................................................w",
        "..@@ee@@ee@@ee@@ee@@ee@@ee@@ee@@ee@@ee@@ee@@ee@@ee@@ee@@ee@@ee@@ee@@ee@@ee@@ee@@ee@@ee@@ee@@ee@@eee@..",
        "..e..............................................................................................@.e..",
        "w.@@ee@@ee@@ee@@ee@@ee@@ee@@ee@@ee@@ee@@ee@@ee@@ee@@ee@@ee@@ee@@ee@@ee@@ee@@ee@@ee@@ee@@ee@@ee@@ee@@.w",
        "......................................................................................................",
        "..@@ee@@ee@@ee@@ee@@ee@@ee@@ee@@ee@@ee@@ee@@ee@@ee@@ee@@ee@@ee@@ee@@ee@@ee@@ee@@ee@@ee@@ee@@ee@@ee@e..",
        "w.e..................................................................................................w",
        "..@@ee@@ee@@ee@@ee@@ee@@ee@@ee@@ee@@ee@@ee@@ee@@ee@@ee@@ee@@ee@@ee@@ee@@ee@@ee@@ee@@ee@@ee@@ee@@eee@..",
        "................................................@................................@...............@.e..",
        "w.@@ee@@ee@@ee@@ee@@ee@@ee@@ee@@ee@@ee@@ee@@ee@@ee@@ee@@ee@@ee@@ee@@ee@@ee@@ee@@ee@@ee@@ee@@ee@@ee@@.w",
        "..e.....................@...........................................@.......................@.........",
        "..@@ee@@ee@@ee@@ee@@ee@@ee@@ee@@ee@@ee@@ee@@ee@@ee@@ee@@ee@@ee@@ee@@ee@@ee@@ee@@ee@@ee@@ee@@ee@@eeee..",
        "w...........@...........................................................@........................@@@.w",
        "..@@ee@@ee@@ee@@ee@@ee@@ee@@ee@@ee@@ee@@ee@@ee@@ee@@ee@@ee@@ee@@ee@@ee@@ee@@ee@@ee@@ee@@ee@@ee@@eee@..",
        "..e......................................................@...........@................................",
        "w.@@ee@@ee@@ee@@ee@@ee@@ee@@ee@@ee@@ee@@ee@@ee@@ee@@ee@@ee@@ee@@ee@@ee@@ee@@ee@@ee@@ee@@ee@@ee@@ee@@.w",
        "............@.......@................@......@......................................................e..",
        "..e@ee@@ee@@ee@@ee@@ee@@ee@@ee@@ee@@ee@@ee@@ee@@ee@@ee@@ee@@ee@@ee@@ee@@ee@@ee@@ee@@ee@@ee@@ee@@ee@@..",
        "..@..............................@...............................@...................................."
    ]
}